ısırık	bite	noun					
ısırma	bite	noun					
ısırmak	to bite	verb					
[biz/onlar/siz] -meliyiz/-meliler/-melisiniz	[we/they/you] must	phrase					
[-den] korkmak	to be scared	verb					
[elinden] düşürmek	to drop [let go]	verb					
[gelecek haftadan] önce değil	not until [next week]	phrase					
[sen] -mamalısın / -memelisin	[you] must not	phrase					
AAA pil	AAA battery	noun					
abanoz	ebony [color]	adj					
abartmak	to exaggerate	verb					
abartmak	to get carried away [fig.]	verb					
abla	elder sister	noun					
ablatif	ablative	noun					
abur cubur	snack	noun					
aç	hungry	adj					
acaba	I wonder	phrase	acaba boş yer var mı? do you have any vacancies?				
acaba	perhaps	adv					
acayip	strange	adj					
acayıp	strange	adj					
acele	rush	noun					
acele	hurry	noun	acele edin: hurry up	acele etmek: to hurry			
Acele et!	Hurry up!	phrase					
acemi	novice	noun					
acemice boyamak	to daub	verb					
acı	pain	noun					
acı	bitter	adj					
acı	hot	adj					
acı	pain	noun					
açık	open	adj					
açık yeşil	light green	adj					
açık yıldız kümesi	open cluster	noun					
açıkçası	frankly	adj					
açıkçası	frankly speaking	adv					
açıklama	statement	noun	yazılı açıklama: written statement				
açıklama	explanation	noun					
açıklama {sg}	statements {pl}	noun					
açıklamak	to explain	verb					
açıklayıcı not	annotation	noun					
acil	urgent	adj					
acil durum	emergency	noun					
acımak	to ache	verb					
açlık	hunger	noun					
açlıktan kıvranmak	to starve	verb					
açmak	to open	verb					
ad	name	noun	adınız ne? what is your name?				
ad	noun	noun					
ad koymak	to call [name]	verb					
ada	island	noun					
ada devleşmesi	insular gigantism	phrase					
ada devleşmesi	island gigantism	phrase					
ada doğanı [Falco eleonorae]	Eleonora's falcon	phrase					
adam	man	noun					
adamak	to dedicate	verb					
adaptasyon	adaptation	noun					
adenozin	adenosine	noun					
adet	custom	noun					
adi	mean	adj					
adı olmak	to be called	verb					
adil	fair	adj					
adım	step	noun	adım atmak: to take a step				
adım	pace	noun					
adım	step	noun					
adres	address	noun					
afalli	aphallia	noun					
Afedersiniz!	Excuse me, please!	phrase					
aferin	well done	phrase					
Aferin!	Well done!	phrase					
Affedersiniz!	Excuse me!	phrase					
Affedersiniz!	Sorry!	phrase					
affetmek	to forgive	verb					
affetmek	to excuse	verb					
affetmek	to forgive	verb					
affını rica etmek	to apologise [Br.]	verb					
Afiyet olsun!	Enjoy your meal!	phrase					
Afrika pengueni [Spheniscus demersus]	African penguin	noun					
afyon	opium	noun					
ağ	net	noun					
ağaç	tree	noun					
ağaç	wood	noun					
ağaç gövdesi	trunk	noun					
ağır	heavy	adj					
ağırlamak	to host sb.	verb					
ağırlık	weight <w., wt.>	noun					
ağız	mouth	noun					
ağlamak	to cry	verb					
ağlamak	to weep	verb					
agnozi	agnosia	noun					
agresif	aggressive	adj					
ağrı	ache	noun					
ağrı	pain	noun					
ağrımak	to hurt	verb					
ağrımak	to ache	verb					
ağusto	August <Aug.>	noun					
ahbap	buddy	noun					
ahbapça	friendly	adj					
ahır	barn	noun					
ahkam	stupid	adj					
ahlak	morality	noun					
ahmak	idiotic	adj					
ahtapot	octopus	noun					
ahududu	raspberry	noun					
aile	family	noun					
ak	white	adj					
ak kumkuşu [Calidris alba]	sanderling	noun					
ak kuyruklu kız kuşu [Vanellus leucurus]	white-tailed lapwing	noun					
ak yanaklı kaz [Branta leucopsis]	barnacle goose	noun					
akaryakıt	liquid fuel	noun	akaryakıt istasyonu: gas station				
akciğer	lung [Pulmo]	noun					
Akdeniz	Mediterranean Sea	noun					
akıl	mind	noun					
akıl	mind [intellect]	noun					
akıllı	bright	adj					
akıllı	clever	adj					
akıllı	intelligent	adj					
akıtmak	to pour	verb					
akmak	to flow	verb					
akondroplazi	achondroplasia	noun					
akrobat	acrobat	noun					
akromegali	acromegaly	noun					
akşam	evening	noun					
akşam	in the evening	adv					
akşam yemeği	dinner	noun					
akşamleyin	in the evening	adv					
aksi halde	else	adv					
aksi taktirde	else	adv					
aksırmak	to sneeze	verb					
aktarmak	to transfer	verb					
aktarmak	to tell	verb					
akuzatif	accusative	noun					
alabalık	trout [a number of species of freshwater fish belonging to the Salmoninae subfamily]	noun					
alaca örümcek kuşu [Lanius nubicus]	masked shrike	noun					
alacakaranlık	twilight	noun					
alakalı	relevant	adj					
alan	area	noun					
alay etmek	to twit	verb					
albinizm	albinism	noun					
alçak	sordid	adj					
alçak [düşük]	low	adj					
alçakgönüllü	humble	adj					
alçakgönüllü	modest	adj					
aldatıcı	dishonest	adj					
aldatmak	to cheat	verb					
alet	machine	noun					
alet	tool	noun					
âlet olan kimse	stooge	noun					
alev	flame	noun					
alev almak	to burn [be on fire]	verb					
alev almak	to burst into flame	verb					
alev almak	to flame [burn]	verb					
alevlenmek	to blaze [burn brightly]	verb					
alevlenmek	to flame [burn]	verb					
algoloji	algology	noun					
alim	scholar	noun					
alın	forehead	noun					
alınmak	to be taken	verb					
alışma	adaptation	noun					
alışmak	to get used to	verb					
alışveriş arabası	cart [Am.]	noun					
alışveriş yapmak	to purchase	verb					
alkım	rainbow	noun					
alkışlamak	to applaud	verb					
Allah aşkına	for god's sake	phrase					
Allah'a ısmarladık!	Goodbye!	phrase					
almak	to take	verb					
almak	to get	verb					
almak	to receive	verb					
almak	to take	verb					
almak	to buy	verb					
Almanca	German	noun					
Almanca'da / İngilizce'de ... nasıl deniyor?	How do you say ... in German / English?	phrase					
Almanya	Germany <.de>	noun					
Alo!	Hello!	phrase					
alt	below	adv					
altı	six	noun					
altı yüz	six hundred	noun					
altın	golden	adj					
altın	gold	noun					
altına	among	prep					
altına	under	prep					
altında	below	adv					
altında	under	prep					
altından	golden	adj					
altmış	sixty	noun					
altmış altı	sixty-six	noun					
altmış beş	sixty-five	noun					
altmış bir	sixty-one	noun					
altmış dokuz	sixty-nine	noun					
altmış dört	sixty-four	noun					
altmış iki	sixty-two	noun					
altmış sekiz	sixty-eight	noun					
altmış üç	sixty-three	noun					
altmış yedi	sixty-seven	noun					
altsınıf	subclass	noun					
aluminyum folyo	kitchenfoil [spv.] [rare]	noun					
alyan [konuş.]	allen key	noun					
alyan anahtarı	allen key	noun					
ama	but	conj					
ama	however	conj					
amaç	goal	noun					
amaç	purpose	noun					
amaç	target	noun					
amaçlamak	to purpose	verb					
ambulans	ambulance	noun					
amca	uncle [father's brother]	noun					
ameliyat	operation	noun					
Amerika nar bülbülü [Turdus migratorius]	American robin	noun					
Amerika puhusu [Bubo virginianus]	great horned owl	noun					
Amerikan	American <Am.>	adj					
amino asit	amino acid	noun					
amir	commander	noun					
amper	ampere	noun					
an	moment	noun					
ana	main	adj					
ana	mother	noun					
ana [konuş.]	mum [Br.] [coll.]	noun					
ana baba	parents	noun					
ana görüş	mainstream	noun					
Anadolu	Anatolia	noun					
anahtar	key	noun					
analitik geometri	analytic geometry	noun					
ananas	pineapple [Ananas comosus]	noun					
anarşi	anarchy	noun					
anarşizm	anarchism	noun					
anasayfa	homepage	noun					
anatomik	anatomical	adj					
ancak	however	conj					
ancak	though	conj					
ancak [gelecek hafta]	not until [next week]	adv					
And kondoru [Vultur gryphus]	Andean condor	noun					
Andorralı	Andorran	noun					
ani	moment	noun	aniden: suddenly				
aniden	suddenly	adv					
anımsamak	to remember	verb					
anjiyoloji	angiology	noun					
anka	phoenix	noun					
anlam	sense	noun					
anlam çıkarmak	to conclude	verb					
anlamak	to grasp	verb					
anlamak	to understand	verb					
anlamına gelmek	to mean	verb					
anlamında olmak	to mean	verb					
Anlamıyorum	I don't understand.	phrase					
anlaşmak	to agree	verb					
anlaşmazlık	disagreement	noun					
anlatım	expression	noun					
anlatmak	to tell	verb					
anne	mother	noun					
anne	mum [Br.] [coll.]	noun					
anne ve baba	parents	noun					
ansiklopedi	encyclopedia	noun					
ant içmek	to swear [oath]	verb					
antik	ancient	adj					
antika	ancient	adj					
antoloji	anthology	noun					
apandisit	appendicitis	noun					
aparat	machine	noun					
aperitif	aperitive	noun					
Apollon	Apollo	noun					
aptal	fool	noun					
aptal	idiotic	adj					
aptal	silly	adj					
ara	intermediate	adj	aranızda: among you				
ara	break	noun	bir ara: for a while	bu arada: meanwhile, by the way			
ara sıra	sometimes	adv					
ara vermek	adjourn	verb					
araba	car	noun					
araç	vehicle	noun					
aracılığıyla	by [via: using the means of]	adv					
aracılığıyla	through	adv					
arada	between	adv					
arada sırada	sometimes	adv					
Arakne	Arachne	noun					
araknoloji	arachnology	noun					
aralarında	among	prep					
aralık	distance	noun					
aralık <ara., ar., r.>	December <Dec.>	noun					
arama	search	noun	üst araması: body search				
arama	exploration	noun					
aramak	to look for	verb					
aramak	to call [telephone]	verb					
aramak	to look for	verb					
aramak	to search	verb					
aramak	to seek	verb					
aranan	wanted	adj					
aranılan	in demand	noun					
aranızda	among you	prep					
arasında	among	prep					
arasında	between	prep					
arasında	under	prep					
arasından	through	adv					
arasıra	occasionally	adv					
araştırma	research	noun					
aratmak	to call	verb					
arayüz	interface	noun					
Ares	Ares	noun					
arı	bee	noun					
arıtmak	to refine	verb					
Arjantin	Argentina	noun					
arka	back	noun	arka tarafta: at the back				
arka plan	background	noun					
arka tarafında	behind	adv					
arkadaş	friend	noun					
arkasında	behind	prep					
arkeoastronomi	archaeoastronomy	noun					
arkeoastronomi	archeoastronomy [Am.]	noun					
arkeogenetik	archaeogenetics [treated as sg.]	noun					
arkeogenetik	archeogenetics [treated as sg.] [Am.]	noun					
armağan	gift	noun					
armağan	present	noun					
armut	pear [Pyrus communis, common pear]	noun					
Arnavut	Albanian	noun					
Arnavutluk	Albania <.al>	noun					
art arda	repeatedly	phrase					
artan	growing	adj					
artan	left [remaining]	adj					
artan	residual	adj					
artı	plus	adj					
artık	no longer	adv					
artık	now	adv					
artık	anymore	adv					
artık	leftover	noun					
artık	residual	adj					
artış	enhancement	noun					
artist	artist	noun					
artmak	to increase	verb					
arzu	desire	noun	ne arzu edersiniz? what would you like?				
asabi	irritable	adj					
aşağı	down	adv	aşağı yukarı: more or less, approximately				
aşağı	under	prep					
aşağı yukarı	approximately	adv					
aşağıda	below	adv					
aşağıda	down	adv					
aşağıda	hereinafter	adv					
aşağılayıcı	humiliating	adj					
aşağıya	down	adv					
asansör	elevator [Am.]	noun					
asansör	lift [Br.]	noun					
aşçı	cook	noun					
aşçılık	cooking	noun					
asıl	main	adj	asıl şimdi: right now				
asimptot	asymptote	noun					
aşırı	extreme	adj					
aşırı	over the top	adj					
asit	acid	noun					
aşk	love	noun	Allah aşkına: for God's sake				
asker	soldier	noun					
asla	ever	adv					
asla	in no case	adv					
asla	never ever	adv					
Asla!	Out of the question!	phrase					
aslan	lion	noun					
aslında	essentially	adv					
aslında	actually	adv					
aşmak	to exceed	verb					
Asperger sendromu <AS>	Asperger's syndrome <AS>	noun					
Asperger sendromu <AS>	Asperger syndrome <AS>	noun					
asteroit	asteroid	noun					
astronomi	astronomy	noun					
Asya	Asia	noun					
at	horse	noun					
ata binmek	to ride	verb					
ataerkil	patriarchal	adj					
ateizm	atheism	noun					
ateş	fire	noun					
ateş	fever	noun					
ateş	fire	noun					
ateş karıştırıcısı	warmonger	noun					
ateşböceği	firefly	noun					
atık	waste	noun					
atılgan	daring	adj					
atla gitmek	to ride	verb					
atlamak	to jump	verb					
ATM	automated teller machine <ATM>	noun					
atmak	to throw	verb					
atmış	sixty	noun					
atölye	workshop	noun					
avanak [argo]	twit [sl.]	noun					
avantaj	advantage	noun					
Avar	Avar	noun					
avcı	hunter	noun					
avize	chandelier	noun					
avlamak	to hunt	verb	gafil avlamak: to take by surprise				
avlamak	to chase	verb					
Avrupa	Europe	noun					
avukat	attorney	noun					
avukat	lawyer	noun					
avukat	lawyer	noun					
Avustralya	Australia <.au>	noun					
Avustralyalı	Australian	noun					
ay	moon	noun					
ay	month <mo.>	noun				
ayak	leg	noun	tek ayak üstünde: on one leg				
ayak	foot	noun	ayakta durmak: to stand
ayak bileği	ankle	noun					
ayak parmağı	toe [Digitus pedis]	noun						
ayak topuğu	heel [of the foot]	noun					
ayakkabı	shoe	noun					
ayakta durmak	to stand	verb					
ayarlamak	to arrange	verb					
ay-ay	aye-aye	noun					
ayçiçeği	sunflower	noun					
aydın	bright	adj					
aydınlatma	clarification	noun					
aydınlık	bright	adj					
aygıt	machine	noun					
ayık	sober	adj					
ayıp	rude	adj					
ayıp	shame	noun					
ayıplamak	to blame	verb					
ayırmak	to reserve	verb					
ayırmak	to separate	verb					
aylık	monthly	adv					
ayna	mirror	noun					
aynen	likewise	adv					
aynı	same	adj					
aynı	the same	pron					
aynı fikirde olmak	to agree	verb					
aynı şekilde	equally	adv					
aynı şekilde	likewise	adv					
aynştaynyum <Es>	einsteinium <Es>	noun					
ayrı	different	adj					
ayrıca	besides	adv					
ayrıca	by the way <BTW>	adv					
ayrıca	else	adv					
ayrılmak	to leave	verb					
ayrımlı	different	adj					
ayrıntılı	detailed	adj					
ayyaş	drunkard	noun					
az	few	adj					
az	little	adj					
az kalsın	almost	adv					
az önce	just	adv					
az önce	recently	adv					
azalmak	to decrease	verb					
azaltmak	to minimise [Br.]	verb					
azarlamak	to berate	verb					
azarlamak	to scold	verb					
azat	liberation	noun					
azat etmek	to free	verb		
için	in order to	phrase					
yapmak için	in order to do sth.	phrase					
baba	dad [coll.]	noun					
baba	father	noun					
bacak	leg	noun					
bacaklar {pl}	legs	noun					
bacı	sister	noun					
badem	almond	noun					
bagaj	baggage	noun					
bagaj	luggage	noun					
bağdaştırmak	to reconcile	verb					
bağımlı	dependent	adj					
bağımsız biçim	free-form	phrase					
bağırmak	to shout	verb					
bağırmak	to yell	verb					
bağırsak	intestine	noun					
bağışıklık sistemi	immune system	noun					
bağışlamak	to donate	verb					
bağışlamak	to forgive	verb					
bağlaç	conjunction	noun					
bağlamak	to bandage	verb					
bağlamak	to connect	verb					
bağlantı	connection	noun	bağlantı koptu: connection lost				
bahane	excuse	noun	hep bir bahane buluyorsun! you always find an excuse!				
baharat	spice	noun					
baharat	spices	noun					
bahçe	garden	noun					
bahçe işleri	gardening	noun					
bahçe tırmaşık kuşu [Certhia brachydactyla]	short-toed treecreeper	noun					
bahis	bet	noun	bahse tutuşmak: to make a bet	bahsi açılmak: to open a discussion			
bahri [Podiceps cristatus]	great crested grebe	noun					
bahsedilen	said	adj					
bahsetmek	to mention	verb					
bahşiş	tip	noun					
bahtiyar	happy	adj					
Baird tapiri [Tapirus bairdii]	Baird's tapir	noun					
bakır <CU>	copper <CU>	noun					
bakış	look	noun	boş bakışlarla: with a blank look				
bakmak	to face	verb					
bakmak	to look	verb					
bakmak	to watch	verb					
bal	honey	noun					
baldır kemiği	shin bone	noun					
Bali Denizi	Bali Sea	noun					
balık	fish	noun					
balina	whale	noun					
balina köpek balığı [Rhincodon typus]	whale shark	noun					
Balmer serileri	Balmer series	noun					
balmumu	wax	noun					
bambaşka	completely different	adj					
bana	me [indirect object]	pron					
bana göre	in my opinion <IMO>	phrase					
bandaj	bandage	noun					
banka	bank	noun					
banliyö	suburb	noun					
banyo	bath	noun	banyo yapmak: to take a bath				
banyo	bathroom	noun					
banyo küveti	bathtub	noun					
barbekü [yab.]	barbecue	noun					
bardak	glass	noun					
bari	at least	adv					
barış	peace	noun					
barıştırmak	to reconcile	verb					
baş	head	noun	en başta: at first				
baş	head [Caput]	noun					
baş yemek	main course	noun					
basamak	step	noun					
başarı	success	noun	başarıyla tamamlanmış: successfully completed				
başarılı	successful	adj					
başarmak	to succeed	verb					
basınçlı hava	compressed air	noun					
basit	simple	adj	basit bir şekilde: in a simple way				
basit	easy	adj					
basit	simple	adj					
basit lokanta	snack bar	noun					
başka	else	adv					
Başka bir şey?	Anything else?	phrase					
başkan	president	noun					
başkent	capital	noun					
başlamak	to begin	verb					
başlamak	to start	verb					
başlangıç	beginning	noun					
başlangıç	start	noun					
basmak	to push	verb					
başörtülü	headscarf	noun					
başparmak	thumb	noun					
başrol	lead role	noun					
başşehir	capital	noun					
bastırmak	to suppress	verb					
baston	walking stick	noun					
başvurmak	to apply	verb					
başvuru	application	noun	başvuru yapmak: to apply				
bataklık kamışçını [Locustella luscinioides]	Savi's warbler	noun					
batı	west	noun	gün batımı: sunset				
batı	west <W>	noun					
batırmak	to sink	verb					
batırmak	to ruin	verb					
battaniye	blanket	noun					
bavul	luggage	noun					
bavul	suitcase	noun					
bayağı	pretty	adv					
bayağı	pretty [coll.]	adv					
bayağı alakarga [Garrulus glandarius]	(Eurasian) jay	noun					
bayağı boyunburan [Jynx torquilla]	Eurasian wryneck	noun					
bayağı çalı kuşu [Regulus regulus]	goldcrest	noun					
bayağı kızılkuyruk [Phoenicurus phoenicurus]	(common) redstart	noun					
bayağı taşçeviren [Arenaria interpres]	(ruddy) turnstone	noun					
bayağı uzunkuyruk [Aegithalos caudatus]	long-tailed bushtit	noun					
bayağı yayın balığı [Silurus glanis]	sheatfish	noun					
bayağı yayın balığı [Silurus glanis]	wels catfish	noun					
bayağı yediuyur [Glis glis]	edible dormouse	noun					
bayan	lady	noun					
bayan tuvaleti	women's restroom [Am.]	noun					
baygın	unconscious	adj					
bayılmak	to be fond of	verb					
bayılmak	to faint	verb					
bayılmak	to pass out	verb					
baykuş	owl	noun					
bazen	sometimes	adv					
bazen	at times	adv					
bazen	sometimes	adv					
bazı	some	adj					
b-e yalan söylemek	to lie to sb.	verb					
b-e zarar vermek	to hurt sb.	verb					
bebek	baby	noun					
beceriksizce boyamak	to daub	verb					
becermek	to get things done	verb					
bedbahtlık	misery	noun					
bedbinlik	pessimism	noun					
bedel	cost	noun					
beden	body	noun	beden eğitimi: physical education				
beden	body size	noun					
beden	size	noun					
beğenmek	to like	verb					
bekar	single	adj					
bekârlık	celibacy	noun					
bekârlık	singledom	noun					
bekçi	warden	noun					
beklemek	to wait	verb					
beklenmek	to be supposed to	verb					
bekleyerek	expecting	adv					
bel	waist	noun					
bela	trouble	noun					
belediye başkanı	mayor	noun					
belediye binası	town hall	noun					
beleş [argo]	free	adj					
belge	document	noun					
belirli	certain	adj					
belirmek	to appear	verb					
belirsiz	ambiguous	adj	belirsiz bir tarihe ertelemek: to postpone to an indefinite date					
belirteç	adverb	noun					
belirtim	annotation	noun					
belirtme sıfatı [Türkçe'de belirli tanımlık yok]	the [Turkish has no definite article]	phrase					
belirtmek	to state	verb					
belirtmek	to imply	verb					
belki	maybe	adv					
belki	perhaps	adv					
belki	probably	adv					
belli	certain	adj					
belli ki	obviously	adv					
bembeyaz	white	adj					
ben	I am	phrase					
ben	I	pron				
Ben Avusturya'danım.	I am from Austria.	phrase					
Ben de! [olumsuz]	Me neither! [coll.]	phrase					
bence	in my opinion	adv						
bencil	selfish	adj					
bende	I have	phrase	bende yok: I don't have				
benekli kedi [Felis margarita]	sand (dune) cat	noun					
benekli sırtlan [Crocuta crocuta]	spotted hyena	noun					
beni	me [direct object]	pron					
Beni ilgilendirmez.	I don't care.	phrase					
benim	my	pron					
Benim adım Frank.	My name is Frank.	phrase					
Benim Adım Kırmızı [Orhan Pamuk]	My Name Is Red	phrase					
Benim sıram.	It's my turn.	phrase					
benzemek	to look alike	verb					
benzemek	to look like	verb					
benzer	like	adv					
benzer	similar	adj					
benzin	petrol [Br.]	noun					
benzin istasyonu	gas station [Am.]	noun					
beraber	together <tog.>	adv					
beraber	with <w/>	prep					
beraberlik	unity	noun					
berbat	awful	adj					
berbat	bad	adj					
bere	cap	noun					
bereket	blessing	noun					
bereket	abundance	noun					
beri	since	adv					
beş	five	noun					
beş bin	five thousand	noun					
beş yüz	five hundred	noun					
beşer	human being	noun					
besin	nutrition	noun					
besin	food	noun					
besin maddeleri	groceries	noun					
beslemek	to feed	verb					
betimlemek	to describe	verb					
beyan {sg}	statements {pl}	noun					
beyan etmek	to declare	verb					
beyaz	white	adj					
beyaz ayı [Ursus maritimus]	ice bear [rare] [polar bear]	noun					
beyaz ayı [Ursus maritimus]	polar bear	noun					
beyaz şarap	white wine	noun					
bezelye	pea	noun					
b-i -bilir	sb. might	phrase					
b-i incitmek	to hurt sb.	verb					
b-i kandırmak	to lie to sb.	verb					
b-i uyandırmak	to wake sb.	verb					
b-i yaralamak	to hurt sb.	verb					
biatlon	biathlon	noun					
biber	pepper	noun					
bıçak	knife	noun					
biçim	shape	noun					
bifobi	biphobia	noun					
biftek	steak	noun					
bıktı	tired	adj	bıktım: I am fed up				
bile	even	adv					
bile bile	on purpose	adv					
bilerek	on purpose	adv					
bilet	ticket	noun					
bilezik	bracelet	noun					
bilgi	knowledge	noun					
bilgisayar	computer	noun					
bilhassa	especially <esp.>	adv					
bilhassa [osm.]	above all	adv					
bilimsel	scientific	adj					
bilinç	consciousness	noun					
bilmek	to know	verb	kim bilir? who knows?				
Bilmem.	I don't know.	phrase					
Bilmiyorum.	I don't know.	phrase					
bilokasyon	bilocation	noun					
bilye	marble	noun					
bin	thousand	noun					
bina	building	noun					
biniş kartı	boarding pass	noun					
bir	one	noun					
bir [belirsiz tanımlık]	a [indefinite article]	phrase					
bir anda	in a moment	adv					
bir arada	together <tog.>	adv					
bir bardak su	a glass of water	phrase					
bir de	in addition	adv					
bir dereceye kadar	somewhat	phrase					
bir gün	one day	adv					
bir hafta içinde	within a week	phrase					
bir kaç	a few	adv					
bir kişinin geçmişi	background	noun					
bir seçim yapmak	to make a choice	verb					
bir şey	something <sth.>	pron					
Bir şey değil!	You are welcome!	phrase					
bir sürü	a lot	noun					
bir yerde	anywhere	adv					
bira	beer	noun					
bırakmak	to leave	verb					
bırakmak	forego	verb					
bırakmak	to leave	verb					
bırakmak	to let	verb					
biraz	a bit	adv					
biraz	a little	adv					
biraz	few	adv					
biraz	somewhat	adv					
birbirinden	from each other	adv					
birçok	a lot	noun					
birçok	many	adj					
birçok	several	adj					
birdenbire	suddenly	adv					
biri	someone	pron					
biri	someone <so.> [subject]	pron					
birikmek	to come together	verb					
biriktirmek	to save	verb					
birinci	first	adv					
birkaç	a couple of	adv					
birkaç	a few	adv					
birkaç	several	adj					
birkaç	some	adv					
birleştirmek	to combine	verb					
birlik	unity	noun					
birlikte	together	adv					
birlikte	together <tog.>	adv					
birlikte	with <w/>	prep					
bisiklet	bike [coll.] [bicycle]	noun					
bisiklete binme	cycling	noun					
bisküvi	biscuit [Br.]	noun					
bitirmek	wind up	verb					
bitiş	conclusion	noun					
bitki	plant	noun					
bitkin	worn-out	adj					
bitme	end	noun					
bitmek	to finish	verb					
bittabi	of course	adv					
bıyık	mustache [Am.]	noun					
bıyıklı baştankara [Panurus biarmicus]	bearded reedling	noun					
bıyıklı baştankara [Panurus biarmicus]	bearded tit	noun					
biyokimya	biochemistry	noun					
biyoloji	biology	noun					
biyopsi	biopsy	noun					
biz	us [direct and indirect object]	pron					
biz	we	pron					
bize	us [direct and indirect object]	pron					
bizim	our	pron					
bizim	ours	pron					
blefarit	blepharitis	noun					
blok	block	noun					
bloknot	pad	noun					
bluz	blouse	noun					
böbrek	kidney	noun					
bodrum	basement	noun					
bodrum	cellar	noun					
boğa köpek balığı [Carcharhinus leucas]	bull shark	noun					
Boğazım ağrıyor.	I have a sore throat.	phrase					
boğmaklı toygar	calandra lark	noun					
böğür	flank	noun					
bölge	area	noun					
bölme	compartment	noun					
bölmek	to interrupt	verb					
bölüm	episode	noun					
bölüşmek	to share	verb					
bomboş	empty	adj					
borç almak	to borrow	verb					
borç vermek	to borrow	verb					
boş	empty	adj					
boş vakit	leisure	noun					
boş zaman	leisure	noun					
boşaltmak	to discharge	verb					
boşanma	divorce	noun					
boşanmış	divorced	adj					
boşta	idle	adj					
boşuna	in vain	adv					
boşver	never mind	phrase					
boşver	Never mind!	phrase					
botulizm	botulism	noun
boylamak	to end up	verb	hapishaneye boylamak: end up in prison					
böyle	in this way	adv					
böyle	like this	adv					
boylu	tall	adj					
boyun	neck	noun					
boyunbağı	tie	noun					
boyut	size	noun					
boz ayı [Ursus arctos]	brown bear	noun					
boz çıvgın [Phylloscopus bonelli]	(western) Bonelli's warbler	noun					
boz ötleğen [Sylvia borin]	garden warbler	noun					
boz yunus [Grampus griseus]	Risso's dolphin	noun					
bozmak	to disturb	verb					
bozmak	to ruin	verb					
bozmak	to blemish [blight]	verb					
bozmak	to blight	verb					
bozmak	to corrupt	verb					
bozmak	to damage [ruin]	verb					
bozmak	to deprave [corrupt]	verb					
bozmak	to distort	verb					
bozmak	to pervert [corrupt]	verb					
bozmak	to ruin [blight]	verb					
bozmak	to spoil [blight]	verb					
bozuk	broken	adj					
bozuk	broke [coll.]	adj					
bozuk	faulty	adj					
bozulmak	to break down	verb					
brendi	brandy	noun					
Brezilya	Brazil <.br>	noun					
Brezilyalı	Brazilian	adj					
bronz	bronze	noun					
bu	this	pron					
bu	those	pron					
bu arada	by the way <BTW>	adv					
bu nedenle	therefore	adv					
bu sebepten dolayı	because of this reason	phrase					
bu yüzden	therefore	adv					
budala	fool	noun					
budala	idiot	noun					
budala	simpleton	noun					
büfe	buffet	noun					
bugün	today	adv					
buji	spark plug	noun					
bükmek	to bend	verb					
bükmek	wind up	verb					
bükülme noktası	inflection point	noun					
bulandırmak	to blur	verb					
bulantı	nausea	noun					
bulaşıcı	contagious	adj					
bulaşık	washing-up	noun					
bülbül	nightingale	noun					
bulmak	to find	verb					
bulmaya çalışmak	to look for	verb					
bulunmak	to lie	verb					
bulunmak	to stand	verb					
buluşma yeri	meeting point	noun					
buluşmak	to meet	verb					
bulut	cloud	noun					
bulutlu	cloudy	adj					
buna rağmen	in spite of that	adv					
bundan dolayı	therefore	adv					
bundan dolayı	thus [therefore]	adv					
bundan sonra	hereinafter	adv					
bunlar	these	pron					
bunlar	those	pron					
bunun için	hence	adv					
bunun için	therefore	adv					
bupropion [C13H18ClNO]	bupropion	noun					
burada	here	adv					
Burada yabancıyım.	I'm a stranger here.	phrase					
buradan	from here	adv					
büro	office	noun					
bürokratik	bureaucratic	adj					
burun	nose	noun	burun kıvırmak: to turn up one's nose				
burun	nose [Nasus]	noun					
buse	kiss	noun					
buton	button	noun					
bütün	all	adj					
bütün	entire	adj					
bütün	whole	adj					
buyrun	here you go	phrase					
Buyrun!	Here you are!	phrase					
büyü	spell	noun	büyü bozulurken: as the spell was broken				
büyü	charm	noun					
büyücü	witch	noun					
büyük	big	adj					
büyük	large	adj					
büyük	tall	adj					
büyük anne-baba	grandparents	noun					
büyük kerkenez [Falco rupicoloides]	greater kestrel	noun					
büyük kerkenez [Falco rupicoloides]	white-eyed kestrel	noun					
büyük mağaza	department store	noun					
büyük örümcek kuşu [Lanius excubitor]	great grey shrike [Br.]	noun					
büyük tarakdiş [Mergus merganser]	common merganser [Am.]	noun					
büyük tarakdiş [Mergus merganser]	goosander [Br.]	noun					
büyükanne	grandmother	noun					
büyükbaba	grandfather	noun					
büyükbaba ve büyükanne	grandparents	noun					
büyüme	enlargement	noun					
büyümek	to grow	verb					
Buyurun!	Here you are!	phrase					
büyütmek	to increase	verb					
buz	ice	noun					
buz pateni	ice skating	noun					
buzdolabı	refrigerator	noun					
buzdolabı	fridge	noun					
buzdolabı	refrigerator	noun					
çabalamak	to struggle	verb					
çabuk	quick	adj	çabuk ol: hurry up				
çabuk	quickly	adv					
çabuk	rapid	adj					
Çabuk!	Hurry up!	phrase					
cadde	road <Rd.>	noun					
cadde	street <St.>	noun					
cadı	witch	noun					
çadır	tent	noun					
çağ	time	noun					
çağdaş	modern	adj					
çağırmak	to invite	verb					
çağırmak	to call	verb					
çağırmak	to get [summon]	verb					
çağırmak	to invite	verb					
çağırmak	to invoke	verb					
çağırmak	to shout	verb					
çağırmak	to summon	verb					
çakı	pocket knife	noun					
çakmak	to hammer	verb					
çakmak	lighter	noun					
çalı	bush	noun					
çalışan	employee	noun					
çalışma	work	noun					
çalışmak	to work	verb					
çalışmak	to struggle	verb					
çalışmak	to work	verb					
çalıştırmak	to operate	verb					
çalmak	to ring	verb					
çalmak	to steal	verb					
cam	window	noun	cam kenarında: by the window				
cam	glass	noun					
cam [konuş.]	window	noun					
çamaşır	washing	noun	çamaşır makinesi: washing machine				
çamaşır	laundry	noun					
cambaz	acrobat	noun					
cami	mosque	noun					
camsı	vitreous	adj					
çamur	sludge	noun					
çamurcun [Anas crecca]	(Eurasian) teal	noun					
çamurcun [Anas crecca]	common teal	noun					
can	life	noun	can kaybı: loss of life				
can çekişme	agony	noun					
can sıkıcı	annoying	adj					
can sıkıcı	boring	adj					
çanak	bowl	noun					
candan	sincere	adj					
canlı yayın	live broadcast	noun					
çanta	bag	noun					
çapkın	rogue	noun					
çare	solution	noun					
çare	remedy	noun					
çare bulmak	to help	verb					
çare olmak	to help	verb					
çaresine bakmak	to remedy	verb					
çaresiz	hopeless	adj					
çaresiz	desperate	adj					
çaresiz	helpless	adj					
çaresizce	hopelessly	adv					
çaresizlik	desperation	noun					
çaresizlik	helplessness [lack of power]	noun					
çaresizlik	impotence [helplessness]	noun					
çarpmak	to shock	verb					
çarpmak	to knock	verb					
çarşaf	sheet	noun					
çarşamba	Wednesday <Wed., We.>	noun					
casus	stooge	noun					
çat	bang	noun					
çatal	fork	noun					
çatal-bıçak takımı	cutlery	noun					
çatı	roof	noun					
çatı	roof [of a building]	noun					
çatı katı	top floor	noun					
çatışma	conflict	noun					
çatışmak	to clash	verb					
çatışmak	to fight	verb					
çatışmak	to skirmish	verb					
çatlamak	to burst	verb					
Cava Denizi	Java Sea	noun					
çay	tea	noun					
çay kaşığı	teaspoon <tsp. / t.>	noun					
çayır	grass	noun					
çayır incir kuşu [Anthus pratensis]	meadow pipit	noun					
ceket	jacket	noun					
çekiç	hammer	noun					
çekingen	shy	adj					
çekinmek	to avoid	verb					
çekiştirmek	to criticize maliciously	verb					
çekmece	drawer	noun	çekmeceli dolap: chest of drawers				
çekmek	to pull	verb					
çekmek	to bear	verb					
çekmek	to pull	verb					
Celebes Denizi	Celebes Sea	noun					
çelik	steel	noun					
çello	cello	noun					
çember	ring	noun					
çember	wheel	noun					
cemiyet	association	noun					
cemiyet	community	noun					
çene	chin	noun					
centilmence	gallantly	adv					
cenubî [osm.]	southern	adj					
cep	pocket	noun					
cep telefonu	cellular phone [Am.]	noun					
cep telefonu	mobile phone [Br.]	noun					
cephesi	facade	noun					
cereyan	current	noun					
çerez	starter [Br.] [appetizer]	noun					
cerrah	surgeon	noun					
cesaret	courage	noun					
çeşidi	variety	noun					
çeşit	sort	noun					
çeşitli	miscellaneous	adj					
çeşme	fountain	noun					
cesur	brave	adj					
cesur	daring	adj					
cetvel	ruler	noun					
cevap	answer	noun					
cevap vermek	to answer	verb					
çevirmek	to turn	verb	içini dışına çevirmek: to turn inside out				
çevirmek	to twist	verb					
çevirmek	wind up	verb					
ceviz	walnut	noun					
çevre	environment	noun					
çevresinde	around	adv					
çevresinde	round	prep					
ceylan	gazelle	noun					
çeyrek	quarter	noun					
çeyrek geçer	a quarter past	phrase					
çeyrek geçiyor	a quarter past	phrase					
ceza	punishment	noun	ceza vermek: to punish				
cezalandırma	punishment	noun					
Cezayir	Algeria	noun					
çiçek	flower	noun					
ciddi	serious	adj	Ciddiye alma! Take it easy!				
ciddi	grave	adj					
ciddi	serious [grave]	adj					
Ciddiye alma!	Take it easy!	phrase					
çift	couple	noun					
çift	double	adj					
çift [aile]	couple [e.g. married couple]	noun					
çift sürmek	to plough	verb					
çiftlik	farm	noun					
çığlık	scream	noun					
çığlık atmak	to scream	verb					
çiğnemek	to chew	verb					
çıkarmak	to remove	verb					
çıkarmak	to take off	verb					
çıkarmak	to take off [to remove]	verb					
çiklet	chewing gum	noun					
çıkmak	to go out	verb					
çıkmak	to leave	verb					
çikolata	chocolate	noun					
çıkrıkçın [Spatula querquedula, syn.: Anas querquedula]	garganey	noun					
çilek	strawberry	noun					
çılgın	mad [insane]	adj					
cilt	skin	noun					
cımbızla almak	to tweeze	verb					
cımbızla yolmak	to tweeze	verb					
çimdik	tweak	noun					
çimen	grass	noun					
çinko nitrat [Zn(NO3)2]	zinc nitrate	noun					
cins	type	noun					
cins	sex	noun					
cinsiyet	gender	noun					
çırak	apprentice	noun					
çirkin	ugly	adj					
çiş	pee	noun					
cisimleştirmek	to reify	verb					
çita [Acinonyx jubatus]	cheetah	noun					
çıtırtı	crackle	noun					
çıtırtı	noise	noun					
çıtkırıldım	fragile	adj					
civarı	vicinity	noun					
civarında	at	prep					
çivi	nail	noun					
çizge	diagram	noun					
çizgili	striped	adj					
çizgili ötleğen [Sylvia nisoria]	barred warbler	noun					
çizme	boot	noun					
çizme	boots {pl}	noun					
çizmek	to draw	verb					
çizmek	to scratch	verb					
çoban	shepherd	noun					
çocuk	child	noun					
çocuk	infant	noun					
çocuk	kid [coll.]	noun					
çocuk	youngster	noun					
çoğalma	increment	noun					
çok	a lot	noun					
çok	a lot of	adj					
çok	many	adj					
çok	much	adv					
çok	too	adv					
çok	very	adv					
çok büyük	huge	adj					
çok güzel	great	adj					
çok iyi	very well	adv					
çok önemli	crucial	adj					
çok sayıda	numerous	adj					
çok şükür ki	fortunately	adv					
Çok teşekkür ederim!	Thank you very much!	phrase					
Çok teşekkürler!	Thank you very much!	phrase					
Çok yaşa!	Bless you! [after sneezing]	phrase					
çokgen	polygon	noun					
çökmek	to collapse	verb					
çökmek	to fall down [also fig.]	verb					
çokterimli	polynomial	noun					
çöl	desert	noun					
çöl koşarı [Cursorius cursor]	cream-colored courser [Am.]	noun					
çöl toygarı [Ammomanes deserti]	desert lark	noun					
cömert	generous	adj					
cömert	generous [liberal, lavish]	adj					
çöp	garbage [Am.]	noun					
çöp	trash [Am.]	noun					
çöp	waste	noun					
çorap	sock	noun					
çorba	soup	noun					
çözmek	to solve	verb					
cübbe	robe	noun					
cüce ipek maymunu [Cebuella pygmaea, syn.: Callithrix pygmaea]	pygmy marmoset	noun					
cüce suaygırı [Choeropsis liberiensis, syn.: Hexaprotodon liberiensis]	pygmy hippopotamus	noun					
cuma	Friday	noun					
cuma	Friday <Fri., Fr.>	noun					
cumartesi	Saturday	noun					
cumartesi <ct., cts.>	Saturday <Sat., Sa.>	noun					
çünkü	as	conj					
çünkü	because	conj					
çünkü	because of	prep					
cüret	courage	noun					
çürümek	to rot	verb					
çürütmek	to refute	verb					
çuval	bag	noun					
cüzdan	purse	noun					
cüzdan	wallet	noun					
da	also	adv					
dağ	mountain	noun					
dağılmak	to scatter	verb					
dağınık	messy	adj					
dağıtmak	to deliver	verb					
daha	more	adv					
daha	still	adv					
daha az	less	phrase					
daha çok	rather	adv					
daha fazla	much more	adv					
daha geç	later	phrase					
daha kötü	worse	phrase					
daha küçük	less	adj					
daha şirin	lovelier	adj					
daha sonra	later	phrase					
dahi	also	adv					
dahi	even	adv					
dahi	likewise	adv					
daima	always	adv					
daire	apartment <apt.> [Am.]	noun					
daire	circle	noun					
daire	flat	noun					
dakik	punctual	adj					
dal	branch	noun					
dalak otu [Teucrium chamaedrys]	wall germander	noun					
dalga	wave	noun					
dalgalı akım	alternating current <AC>	noun					
damat	bridegroom	noun					
damat	groom [bridegroom]	noun					
damat	son-in-law	noun					
damla	drop	noun					
damlamak	to drip	verb					
dana eti	veal	noun					
Danimarka	Denmark	noun					
danışmak	to consult	verb					
dans	dance	noun					
dans etmek	to dance	verb					
dansçı	dancer	noun					
dansör	dancer	noun					
dar	narrow	adj					
darbe	blow	noun					
darbe	hit	noun					
darı	millet	noun					
datif	dative	noun					
davet	invitation	noun					
davet etmek	to invite	verb					
davul	drum	noun					
davul çalmak	to drum	verb					
dayanarak	based on	prep					
dayanıklı	impervious	adj					
dayanım	strength	noun					
dayanmak	to withstand	verb					
dayı	uncle [mother's brother]	noun					
de	also	adv					
de	likewise	adv					
de / da	as well	adv					
de / da	too	adv					
de hali	locative	noun					
dede	grandpa [coll.]	noun					
dede ve nine	grandparents	noun					
dedikodu	gossip	noun					
değer	value	noun					
değer azalması	depreciation	noun					
değer kaybı	depreciation	noun					
değerlendirme	evaluation	noun					
değerlendirme	assessment	noun					
değerli	precious [valuable]	adj					
değerli	substantial [valuable]	adj					
değerli	treasured	adj					
değerli	valuable	adj					
değerli	worthy [of a person]	adj					
değil	not	phrase	değil mi: isn't it				
değişik	different	adj					
değişmek	to change	verb					
değiştirmek	to change sy	verb					
değiştirmek	to alter	verb					
değiştirmek	to change	verb					
değiştirmek	to replace	verb					
dehşet [argo]	awesome [Am.] [coll.]	adj					
dehşetli	horrendous	adj					
deli	mad	adj					
deli	crazy	adj					
deli	madman	noun					
deli	mad [insane]	adj					
delik	hole	noun					
delil	proof	noun					
delinmek	to being pierced	verb					
delmek	to pierce	verb					
demeç	speech	noun					
demeç {sg}	statements {pl}	noun					
demek	to say	verb					
demek istemek	to mean	verb					
demek olmak	to mean	verb					
demilitarizasyon	demilitarization	noun					
demir [element]	iron <Fe>	noun					
demirbaş	fixtures {pl}	noun					
demirbaşı	fixture	noun					
demirci	ironmonger	noun					
demokrasi	democracy	noun					
den hali	ablative	noun					
denemek	to attempt	verb					
denemek	to try on	verb					
denemek	to try	verb					
deneyim	experience	noun					
denilen	said	adj					
denilmek	to be called	verb					
deniz	sea	noun					
deniz	sea [also fig.]	noun					
deniz düdükçünü [Phalaropus lobatus]	red-necked phalarope	noun					
deniz feneri	lighthouse	noun					
deniz tutmuş	seasick	adj					
deniz ürünleri	seafood	noun					
denk	equivalent	adj					
deoksiribonükleik asit <DNA>	deoxyribonucleic acid <DNA>	noun					
deprem	earthquake	noun					
depresyon	depression	noun					
derhal	immediately	adv					
deri	skin	noun					
deri	leather	noun					
derin	deep	adj					
derman	remedy	noun					
dernek	association	noun					
dert	trouble	noun					
deser	dessert	noun					
destek	support	noun					
destek	help	noun					
destek çıtası	stringer	noun					
detaylı	detailed	adj					
dev	giant	noun					
deva	remedy	noun					
devam etmek	to continue	verb					
devamlı	frequent	adj					
devasa	enormous	adj					
deve	camel	noun					
devimsel	kinetic	adj					
devir	age	noun					
devir	era	noun					
devlet	state	noun					
devlet desteği	subsidy	noun					
dezavantaj	disadvantage	noun					
diğer	other	pron					
dikdörtgen biçiminde	rectangular	adj					
dikdörtgenli	rectangular	adj					
diken	thorn	noun					
dikey stabilize	vertical stabilizer	noun					
dikkat	attention	noun	dikkat dağılması: distraction	dikkati çekmek: to draw attention			
Dikkat et!	Be careful!	phrase					
dikkat etmek	to look out	verb					
dikkatli	careful	adj					
dikkatsiz	careless	adj					
dikmek	to sew	verb					
diksiyon	diction	noun					
dikuçar	helicopter	noun					
dil	language <lang.>	noun					
dil	tongue	noun					
dilemek	to ask for [request]	verb					
dindar	devout	adj					
dindar	religious	adj					
dinlemek	to hear	verb					
dinlemek	to listen	verb					
dinlenme	rest	noun					
dinlenmek	to have a rest	verb					
dinlenmek	to rest	verb					
dinleti	concert	noun					
dinmek	to stop	verb	yağmur diniyor: the rain is stopping					
dip	bottom	noun	denizin dibinde: at the bottom of the sea				
dip	bottom [of receptacles]	noun					
dip notu	annotation	noun					
direniş	resistance	noun					
dirsek	elbow	noun					
diş	tooth	noun					
diş ağrısı	toothache	noun					
diş dibi çapı	minor diameter	noun					
diş doktoru	dentist	noun					
diş fırçası	toothbrush	noun					
dış gezegen	outer planet	noun					
diş hekimi	dentist	noun					
diş macunu	toothpaste	noun					
disakkarit	disaccharide	noun					
dışarı	outside	noun					
dışarı	out	adv					
dışarıya	out	adv					
dişçi	dentist	noun			
divan	sofa	noun					
diye	in order to	conj					
diye	such	conj					
diz	knee	noun					
diz	knee [Genu]	noun					
dizi	series	noun					
doğal	natural	adj	doğal sayılar: natural numbers				
doğranmış	chopped	adj					
doğru	correct	adj					
doğru	right	adv					
doğru	straight	adv					
doğru	TRUE	adj					
doğru akım	direct current <DC>	noun					
doğrultmak	to point	verb					
doğrultusunda	in line with	phrase					
doğrusu	frankly speaking	adv					
doğrusu	indeed	adv					
doğrusu	to be honest	adv					
doğu	east <E>	noun					
doğu	eastern	adj					
Doğu Avrupa	Eastern Europe	noun					
doğum	birth	noun					
doğum günü	birthday	noun					
doğurma	birth	noun					
dökmek	to pour	verb					
doksan	ninety	noun					
doktor	doctor	noun					
doktor	physician	noun					
dokumak	to weave	verb	ince eleyip sık dokumak: to scrutinize				
doküman	document	noun					
dokunma	touch	noun					
dokunmak	to touch	verb					
dokuz	nine	noun					
dokuz yüz	nine hundred	noun					
dolap	cupboard	noun					
dolaşma	walk	noun					
dolaşmak	to wander	verb					
dolayı	because	conj					
dolayından	because of	prep					
doldurmak	to fill	verb					
doldurmak	to stuff	verb					
dolu	full	adj					
domates	tomato	noun					
domatesler {pl}	tomatoes	noun					
domuz	pig	noun					
domuz budu	ham	noun					
domuz eti	pork	noun					
donanım	hardware	noun					
dondurma	ice cream	noun					
döndürmek	to twist	verb					
döndürmek	wind up	verb					
dönme momenti	torque	noun					
dönmek	to face	verb					
dönmek	to turn	verb					
dönüm noktası	inflection point	noun					
Dorian Gray'in Portresi	The Picture of Dorian Gray [Oscar Wilde]	phrase					
dört	four	noun					
dört bin	four thousand	noun					
dört yüz	four hundred	noun					
dosdoğru	straight ahead	adv					
dost	friend	noun					
dostluk	friendship	noun					
dosya	file	noun					
dosya	folder	noun					
döviz kuru	exchange rate	noun					
dövmek	to beat	verb					
dövüşmek	to fight	verb					
doymuş	full (up)	adj					
doyurmak	to feed	verb					
dua etmek	pray	verb					
dübel	Rawlplug™	noun					
dübel	wall plug	noun					
dudak	lip	noun					
düğme	button	noun					
düğme	switch	noun					
dugong [Dugong dugon]	dugong	noun					
düğüm	knot	noun					
düğüm teorisi	knot theory	noun					
düğün	wedding	noun					
dükkân	shop	noun					
dükkân	store [Am.]	noun					
dul kadın	widow	noun					
dümdüz	straight on	adv					
dümen	rudder	noun					
dün	yesterday	adv					
dünya	world	noun					
dur	stop	noun					
Dur!	Stop!	phrase					
Dur!	Stop it!	phrase					
durdurmak	to stop	verb					
durmak	to stop	verb					
dürtü	urge	noun					
durum	status	noun					
durum	occasion	noun					
durum	situation	noun					
dürüst olarak	to be honest	adv					
dürüst olmak gerekirse	frankly speaking	phrase					
dürüst olmayan	dishonest	adj					
dürüstçe	faithfully	adv					
dürüstçe	to be honest	adv					
duş	shower	noun					
düşey asimptot	vertical asymptote	noun					
düşman	enemy	noun					
düşmek	to fall	verb					
düşük	low	adj					
düşük	low	adj					
düşünce	opinion	noun					
düşünce	thought	noun					
düşüncesiz	careless	adj					
düşündürmek	to suggest	verb					
düşünmek	to think	verb					
dut	mulberry	noun					
duvar	wall	noun					
duygu	feeling	noun					
duymak	to feel	verb					
duymak	to hear	verb					
duyu	sense	noun					
duyumsamak	to feel	verb					
düz	flat	adj					
düz	smooth	adj					
düz	straight	noun					
düzeltme	retouching	noun					
düzeltmek	to correct	verb					
düzeltmek	to fix	verb					
düzeltmek	to correct	verb					
düzeltmek	to improve	verb					
düzeltmek	to tidy up	verb					
düzenlemek	to organize	verb					
düzenli	regular	adj					
düzgün	straight	adj					
e hali	dative	noun					
ebediyen	forever <4E>	adv					
ebediyet	eternity	noun					
ebemkuşağı	rainbow	noun					
ebeveyn	parents {pl}	noun					
ecnebi	foreigner	noun					
eczacı	pharmacist	noun					
eczane	pharmacy	noun					
edebiyat	literature	noun					
edep	civility	noun					
edinmek	to get	verb					
edinmek	to receive	verb					
Efendim?	I beg your pardon?	phrase					
Efendim?	Pardon?	phrase					
efsane	myth	noun					
efsane	legend	noun					
eğe	file	noun					
Ege Denizi	Aegean Sea	noun					
eğer	if	conj					
eğer	when	conj					
eğer ... olmazsa	unless	conj					
eğilim göstermek	to tend to	verb					
eğilimi olmak	to tend to	verb					
eğilmek	to lean	verb					
eğitim	study	noun					
eğlence	fun	noun					
eğlence	entertainment	noun					
eğlenceli	enjoyable	adj					
eğlendirmek	to entertain	verb					
eğmek	to bend	verb					
eğmek	to bow	verb	boyun eğmek: to bow, to submit, to surrender				
egoist	selfish	adj					
Ejder Yürek	Dragonheart [Rob Cohen]	phrase					
Ekim	October	noun					
ekim <eki., ek., e.>	October <Oct.>	noun					
ekin kargası [Corvus frugilegus]	rook	noun					
ekin yelvesi [Emberiza calandra, syn.: Miliaria calandra]	corn bunting	noun					
eklemek	to add	verb					
ekmek	bread	noun					
ekoloji	ecology	noun					
ekran	screen	noun					
ekşi	sour	adj					
eksponansiyel	exponential	adj					
el	hand	noun	ele almak: to handle	ele alınmak: to be handled			
el feneri	flashlight	noun					
el feneri	torch [Br.]	noun					
el lambası	flashlight	noun					
el sallamak	to wave	verb					
elastik	elastic	adj					
elbette	of course	adv					
elbette	certainly	adv					
elbette	of course	adv					
elbise	dress	noun					
elbise	clothes	noun					
elbise kolu	sleeve	noun					
elde etmek	to get	verb					
elde etmek	to receive	verb					
eldiven	glove	noun					
eldivenler {pl}	gloves	noun					
ele verme	betrayal	noun					
elektrik düğmesi	light switch	noun					
elektrik fişi	plug	noun					
elektrik traş makinası	electric razor	noun					
elektrot	electrode	noun					
elemanlar {pl}	labour [Br.]	noun					
eli açık	generous [liberal, lavish]	adj					
elli	fifty	noun					
elma	apple [Malus domestica]	noun					
elma suyu	apple juice	noun					
elmalı pasta	apple pie	noun					
emek	labour	noun	emek vermek: to work hard				
emin	confident	adj	emin değilim: I am not sure	emin misin? are you sure?	eminim değildir: I'm sure not		
emin	certain	adj					
emin	confident	adj					
emin	sure	adj					
emniyet	police station	noun					
emri	order	noun					
en azından	at least	adv					
en büyük	largest	adj					
en son	last	adj					
en sonunda	eventually	adv					
endişe	anxiety	noun					
endişe	concern	noun					
endişelenmek	to worry	verb					
endişeli	anxious	adj					
engelli insan	disabled person	noun					
enişte	brother-in-law	noun					
enişte	uncle [related by marriage]	noun					
ensiz	narrow	adj					
enteresan	interesting	adj					
entoksikasyon	intoxication	noun					
epey	fairly	adv					
epilasyon	epilation	noun					
ergin	adult	noun					
erguvani balıkçıl [Ardea purpurea]	purple heron	noun					
erik	plum	noun					
eril	male	adj					
erişkin	adult	noun					
erkek	male	adj					
erkek	man	noun					
erkek arkadaş	boyfriend	noun				
erkek tuvaleti	men's restroom [Am.]	noun					
erkek yeğen	nephew	noun				
erken	early	adj					
ertelemek	adjourn	verb					
ertelemek	to postpone	verb	[belirsiz bir tarihe / süresiz olarak] ertelemek: to postpone to an indefinite date			
ertesi	next	adj	ertesi sabah: next morning				
eş	mate	noun					
eş	spouse	noun					
eş [kadın]	wife	noun					
eşek	donkey	noun					
eser	piece	noun					
eşevreli	coherent	adj					
eşey	gender	noun					
esintili	windy	adj					
eşit	equal	adj					
eşittirmek	to equalize	verb					
eski	ancient	adj					
eski	old	adj					
eski zamandan kalma	ancient	adj					
eskiçağ	antiquity	noun					
eskimiş	old	adj					
eşlenmek	to be paired	verb					
esnasında	during	prep					
eşya	item	noun					
et	meat	noun	etliye sütlüye karışmamak: not interested in anything				
et yemeyen	vegetarian	adj					
etek	skirt	noun					
etiket	label	noun					
etkilenmez	impervious	adj					
etmek	to do	verb					
etmek	to make	verb					
etnoloji	ethnology	noun					
etrafında	around	adv					
etrafında	round	prep					
Etrüsk	Etruscan	adj					
etyemez	vegetarian	adj					
Euripides	Euripides	noun					
ev	home	noun					
ev	house	noun					
ev sahibi	host	noun					
evcil hayvan	pet	noun					
evde	at home	adv					
evet	yes	part					
evlat	child	noun					
evlenme	marriage	noun					
evlenmek	to marry	verb					
evlenmiş	married	adj					
evli	married	adj					
evlilik	marriage	noun					
evvel	ago [postpos.]	adv					
evvela	in the first place	adv					
evvelki gün	the day before yesterday	adv					
evvelsi gün	the day before yesterday	adv					
eylem	action	noun					
eylem	deed [act]	noun					
eylem	verb	noun					
eylül <Eyl., Ey., L>	September <Sep., Sept.>	noun					
eyvah	oops	phrase					
ezmek	squish	verb					
fısıldamak	to whisper	verb					
faaliyet	activity	noun					
fabrika	plant [factory]	noun					
faiz	interest	noun					
fakat	but	conj					
fakat	however	conj					
fakat	though	conj					
falan	and so on <ASO>	adv					
fantastik	fantastic	adj					
far	headlight	noun					
fare	mouse	noun					
fark	difference	noun	fark etmek: to notice				
Farketmez!	Never mind!	phrase					
farkında	aware	adj					
farkında olmak	to be aware of	verb					
farklı	different	adj					
Fas	Morocco	noun					
fasulye	bean	noun					
fatura	bill	noun					
faydalı	useful	adj					
fazla	extra	adj	daha fazla: more				
fazla	too	adv					
fazla mesai	overtime	noun					
Fazlaca kalabalıktı.	It was too crowded.	phrase					
fazladan	over the top	adj					
femtokimya	femtochemistry	noun					
fena	evil	adj					
fena	bad	adj					
fener	torch	noun					
fener kulesi	lighthouse	noun					
ferah	spacious	adj					
ferahlamak	to be relieved	verb					
fevkalade	fabulous	adj					
fevkalade	great	adj					
fiil	verb	noun					
fikir	idea	noun					
fikir	mind [opinion]	noun					
fikir	opinion	noun					
fikoloji	phycology	noun					
fil	elephant	noun					
filantropizm	philanthropy	noun					
filiz	sprout	noun					
filozof	philosopher	noun					
fincan	cup	noun					
fındık	nut	noun					
Finlandiya	Finland	noun					
firar kenarı	trailing edge	noun					
fırça	brush	noun					
fırça atmak	berate	verb					
fırçalamak	to brush	verb					
fırın	bakery	noun					
fırın	stove	noun					
fırında pişirmek	to bake	verb					
firkete	hairpin	noun					
fırlatmak	to launch	verb					
fırsat	opportunity	noun					
fırtına	hurricane	noun					
fıstık	peanut	noun	yer fıstığı: peanut
fiş	receipt	noun					
fiş [elektrik]	plug	noun					
fışkırmak	to gush out	verb					
fiyat	price	noun					
Fiyatı nedir?	How much is it?	phrase					
florya [Carduelis chloris]	(European) greenfinch	noun					
fosil	fossil	noun					
fotoğraf	photo	noun	fotoğraf çekmek: to take a photo				
fotoğraf	photograph	noun					
fotoğraf	photo	noun					
fotoğraf çekmek	to take a photograph	verb					
fotoğraf makinesi	camera	noun					
fotoğraflamak	to take a photograph	verb					
fotorealizm	photorealism	noun					
fotosentez	photosynthesis	noun					
Fransa	France <.fr>	noun					
Fransızca	French <Fr.>	adj					
fruktoz	fructose	noun					
futbol	football	noun					
füze	missile	noun					
gafil	careless	adj	gafil avlamak: to take by surprise				
galaksi	galaxy	noun					
galiba	I guess	phrase					
galiba	probably	adv					
galyum arsenür [GaAs]	gallium arsenide	noun					
gama fonksiyonu	gamma function	noun					
Gana	Ghana <.gh>	noun					
gar	train station	noun					
garaj	garage	noun					
garantiye almak	to insure	verb					
garip	odd	adj					
garip	strange	adj					
garson	waiter	noun					
garson [kadın]	waitress	noun					
gastrulasyon	gastrulation	noun					
gayesiyle	for the purpose of	adv					
gayet	very	adv					
gayretli	hardworking	adj					
gaz	gas	noun					
gazete	newspaper	noun					
gazeteci	journalist	noun					
gazetecilik	journalism	noun					
gazino	casino	noun					
gazoz	soda [Am.]	noun					
gazsız	still [drink]	adj					
gebertmek	to kill	verb					
geç	late	adj					
gece	night	noun	geceleri: at nights				
gece	at night	adv					
gece	night	noun					
gece yarısı	midnight	noun					
geceleri	at night	adv					
geceleyin	at night	adv					
geçerli	valid	adj					
gecikme	delay	noun					
geciktirmek	to postpone	verb					
geçim	living	noun					
geçindirmek	to make ends meet	verb					
geçinmek	to make a living	verb					
geçirmek	to pass	verb					
geçirmek	to spend	verb					
geçirmez	impervious	adj					
geçmek	to pass by	verb	gelip geçici: passing				
geçmek	to exceed	verb					
geçmiş	past	adj					
gelecek	future	noun					
gelecekte	hereinafter	adv					
gelin	bride	noun					
gelin	daughter-in-law	noun					
gelir	revenue	noun					
geliş	arrival <arr.>	noun					
geliştirmek	to develop	verb					
geliştirmek	to improve	verb					
gelmek	to come	verb					
gemi	ship	noun					
genç	young	adj					
gençlik yurdu	hostel	noun					
gençlik yurdu	youth hostel	noun					
gene	again	adv					
genel	usual	adj					
genelde	usually	adv					
genelev	brothel	noun					
genetik	genetics	noun					
geniş	broad	adj					
geniş	widespread	adj					
geniş	large	adj					
geniş	wide	adj					
genişletmek	to enlarge	verb					
genitif	genitive	noun					
geometrik ortalama	geometric mean	noun					
gerçek	correct	adj					
gerçek	fact	noun					
gerçek	genuine	adj					
gerçek	truth	noun					
gerçekleştirmek	to realize	verb					
gerçekten	really	adv					
gerçekten	indeed	adv					
gerçekten	in fact	adv					
gerçekten	quite	adv					
gerçekten	really	adv					
gerçekten	to be honest	adv					
gerçekten	truly	adv					
gerçi	though	adv					
gerek	requirement	noun					
gerekli	necessary	adj					
gerekli	required	adj					
gerekmek	to be necessary	verb	gerekirse: if necessary	gerek yok: not necessary	gerek yok zaten: no need anyway		
gerekmek	to be supposed to	verb					
gerekmek	to need	verb					
gerektirmek	to require	verb					
gergedan	rhinoceros	noun					
geri	back	adj	geri götürmek: to return sg				
geri çekilme	retreat	noun					
geri çevirmek	to reject	verb					
gerileme	retreat	noun					
gerizekâlı	retarded [sl.]	adj					
getirmek	to bring	verb					
getirmek	to get	verb					
gevşek	loose	adj					
gevşek	slack	adj					
geyik	deer	noun					
gezi	trip	noun					
gezinmek	to wander around	verb					
gezinti	walk	noun					
gibi	as	adv					
gıda	food	noun					
gıda maddeleri	groceries	noun					
Gidelim!	Let's go!	phrase					
gidip gelmek	to commute	verb	evle iş arasını gidip gelmek: to travel between home and work					
gidip görmek	to visit	verb					
gık	squeak	noun	gık dememek: not to say a word				
gimnofobi	gymnophobia	noun					
giriş	entrance	noun					
girişim	attempt	noun					
gırtlak	throat	noun					
gitmek	to go	verb					
gitmek	to leave	verb					
giyinmek	to get dressed	verb					
giyinmek	to dress	verb					
giymek	to wear	verb					
giymek	to put on [clothes]	verb					
gizlemek	to hide	verb					
gizli	secret	adj					
glikoz	glucose	noun					
göbek deliği	bellybutton [coll.]	noun					
göçebe	nomad	noun					
göçmek	to emigrate	verb					
göçmek	to migrate	verb					
göğüs	chest	noun					
göğüs	breast	noun					
gök	sky	noun					
gök ardıç kuşu [Monticola solitarius]	blue rock thrush	noun					
gök balina [Balaenoptera musculus]	blue whale	noun					
gök gürlemesi	thunder	noun					
gök gürültüsü	thunder	noun					
gökada	galaxy	noun					
gökbilim	astronomy	noun					
gökbilimi	astronomy	noun					
gökçe güvercin [Columba oenas]	stock dove	noun					
gökdelen	skyscraper	noun					
gökkuşağı	rainbow	noun					
göknar kargası [Nucifraga caryocatactes]	(Eurasian) nutcracker	noun					
göktaşı	meteor	noun					
gökyüzü	sky	noun					
göl	lake	noun					
gölge	shadow	noun	gölge etmek: to stand in one's way				
gölgeli	shady	adj					
gömlek	shirt	noun					
gömmek	to bury	verb					
göndermek	to send	verb					
gönül	heart	noun					
görev	duty	noun					
görevlendirme	employment	noun					
görmek	to see	verb					
görmeye gitmek	to visit	verb					
görmezden gelmek	to ignore	verb					
görülecek yer	sight	noun					
görülmeye değer	worth seeing	adj					
görünmek	to seem	verb					
görünmek	to appear	verb					
görünmek	to look	verb					
görüntü	image	noun	kamerası görüntüsü: camera footage				
görünür	visible	adj					
Görüşme üzere!	See you soon!	phrase					
görüşmek	to meet	verb	görüşmek üzere: see you				
görüşmek	to talk	verb					
Görüşürüz!	See you!	phrase					
Görüşürüz!	See you soon!	phrase					
Görüşürüz.	See you.	phrase					
göstermek	to show	verb					
göstermek	to prove	verb					
göstermek	to show	verb					
göt	ass	noun					
götürmek	to carry	verb					
götürmek	to take	verb					
götürmek	to bring	verb					
gövde	fuselage	noun					
göz	eye	noun	gözler dört açmış: eyes wide open	gözler önüne sermek: to reveal			
göz	eye [Oculus]	noun					
göz kırpmak	to blink	verb					
göz kırpmak	to wink	verb					
gözaltı	custody	noun	gözaltına almak: to detain				
gözden geçirmek	to look at	verb					
gözetlemek	to observe	verb					
gözlük	glasses	noun					
gözlük	spectacles	noun					
gözlük	glasses	noun					
gözü pek	daring	adj					
gözükmek	to appear	verb					
gözyaşı	tear	noun					
gözyaşı dökmek	to weep	verb					
gri	gray [Am.]	adj					
grup	group	noun					
güç	force	noun					
güç	power	noun					
gücendirmek	to hurt	verb					
gücendirmek	to insult	verb					
gücenmiş	hurt	adj					
güçlü	strong	adj					
güçsüz	weak	adj					
gül	rose	noun					
güle	bye	phrase	güle güle: bye				
Güle güle!	Bye!	phrase					
Güle güle!	Goodbye!	phrase					
gülme	laugh	noun					
gülmek	to laugh	verb	katıla gülmek: to laugh out loud				
gülümseme	smile	noun						
gülümsemek	to smile	verb					
gülünecek	funny	adj					
gülüş	laugh	noun					
gümrük	customs duty	noun					
gümüş	silver	adj					
gümüş uçlu köpekbalığı [Carcharhinus albimarginatus]	silvertip shark	noun					
gün	sun	noun	gün doğmadan: before sunrise	gündoğumu: sunrise	güpegündüz: in broad daylight		
gün	day	noun	günlerde: at days	günün birinde: some day			
gün ağarması	dawn	noun					
gün batısı	sunset	noun					
gün batımı	sunset	noun					
günah	sin	noun					
Günaydın!	Good morning!	phrase					
günbatımı	sunset	noun					
güncel	current	adj					
gündelik	daily	adj					
gündöndü	sunflower	noun					
gündüz	daytime	noun					
gündüz	day	noun					
günebakan	sunflower	noun					
güneş	sun	noun					
güneş batışı	sunset	noun					
güneş doğması	sunrise	noun					
güneş doğuşu	sunrise	noun					
güneş kremi	sun creme	noun					
güneş kremi	sunscreen	noun					
güneşin batısı	sunset	noun					
güneşin doğuşu	sunrise	noun					
güneşlenmek	to sunbathe	verb					
güneşli	sunny	adj					
güney	southern	adj					
güney	south	noun					
güneyde bulunan	southern	adj					
günlük	daily	adj					
günün saati	time of day	noun					
güpegündüz	in broad daylight	phrase					
gür	strong	adj					
Gürcü	Georgian	noun					
gürültü	noise	noun					
gürültü	sound	noun					
gürültülü	loud	adj					
gurur	pride	noun	gurur duymak: to be proud of				
gururlu	proud	adj					
güven	confidence	noun	kendine güvenen: to be self-confident				
güven	trust	noun					
güvenilir	credible	adj					
güvenilir	reliable	adj					
güvenilirlik	credibility	noun					
güvenmek	to believe	verb					
güvercin	pigeon	noun					
güzel	beautiful	adj	her şey güzeldi: everything was fine				
güzel	fine	adv					
güzel	good	adj					
güzel	pretty	adj					
güzellik	beauty	noun					
haber	news	noun	ne haber? what's up?	hayırlı haberler: good news			
haber	information	noun	haberim var: I'm aware of it				
haber	message	noun					
haberi olmak	to know	verb				
hac	pilgrimage	noun					
haç	cross	noun					
haddinden fazla	over the top	adj					
hadi	let's	phrase					
Hadi!	Come on!	phrase					
Hadi!	Go ahead!	phrase					
hafıf	lightly	adv					
hafıf	light	adj					
hafıza	memory	noun					
hafta	week	noun	hafta sonu: weekend				
hafta arası	weekday	noun					
hafta içi	weekday	noun					
hafta sonu	weekend	noun					
haftanın günü	day of the week	noun					
haftasına kalmaz	within a week	phrase					
hagiografi	hagiography	noun					
hainlik	betrayal	noun					
hak	right	noun	hak etmek: to deserve				
hak	justice	noun					
hak iddia etmek	to claim	verb					
hakaret etmek	to insult	verb					
hakikat	fact	noun					
hakikaten	truly	adv					
hakikaten	in fact	adv					
hakikaten	really	adv					
hakikaten	truly	adv					
hakiki	genuine	adj					
hâkim görüş	mainstream	noun					
hakkında	about	prep					
hakkında	on	prep					
hal	status	noun	hale geldi: has become	haliyle: as it stands			
hal	situation	noun					
hala	still	adv					
hala	aunt	noun					
hala	aunt [father's sister]	noun					
hala	still	adv					
hâlâ	still	noun					
halbuki	however	conj					
halı	carpet	noun					
halis	pure	adj					
halka	ring	noun					
hamilelik	pregnancy	noun					
hamle	move	noun	hamle yapmak: to make a move				
Hamsin Yortusu	Pentecost	noun					
hangi	which	pron					
hangisi	which	pron					
hani	you know	phrase					
hanım	lady	noun					
hapishane	prison	noun									
hapşırmak	to sneeze	verb					
hardal	mustard	noun					
hareket	action	noun	harekete geçmek: to take action				
hareket	move	noun					
hareket etmek	to move	verb					
hareket ettirmek	to move	verb					
hareketli	active	adj					
harf	letter	noun					
harflemek	to spell	verb					
hariç	except	prep					
harika	awesome [Am.] [coll.]	adj					
harika	fabulous	adj					
harika	great	adj					
harika	superb	adj					
harita	map	noun					
harman	harvest	noun						
hasar	damage	noun	hasara uğratmak: to damage
hasat	harvest	noun					
hasım	inimical	adj					
haşiye	annotation	noun					
haşlamak	to whack	verb					
hassas	sensitive	adj					
hasta	ill	adj					
hasta	patient	noun					
hasta	sick	adj					
hastalanma	disease	noun					
hastalık	disease	noun					
hastane	hospital	noun					
hastel	hostel	noun					
hat	line	noun					
hata	mistake	noun					
hata	error	noun					
hata	fault	noun					
hata	mistake	noun					
hata mesajı	error message	noun					
hatalı	false	adj					
hatasız	right	adj					
hatır	sake	noun
hatır	respect	noun
hatırlamak	to remember	verb					
hatırlatmak	to remind	verb					
hatta	even	adv					
hatta	yet	adv					
hatta	even	adv					
hava	air	noun					
hava	weather	noun					
hava atmak	to show off	verb					
hava durumu	weather forecast	noun					
hava limanı	airport	noun					
havaalanı	airport	noun					
havacılık	aeronautical	adj					
havacılık mühendisi	aeronautical engineer	noun					
havada süzülmek	to sail	verb					
havalimanı	airport	noun					
havayolu şirketi	airline	noun					
havlamak	to bark	verb					
havlu	towel	noun					
havşa	countersink	noun					
havuç	carrot	noun					
havuz	pool	noun					
hayal	dream	noun					
hayal	shadow	noun					
hayal gücü	imagination	noun					
hayal kırıklığı	disappointment	noun					
hayat	life	noun	hayatım: my dear	hayatta gelmek: to come alive	hayatta kalmak: to survive		
hayda	come on	phrase					
hayır	no	adv					
hayırdır	what's wrong	phrase					
Hayırlı sabahlar!	Good morning!	phrase					
hayli	quite a lot	adj	bir hayli: pretty much				
hayran kalmak	to admire	verb					
hayran olmak	to admire	verb					
hayret	surprise	noun	hayret etmek: to marvel				
hayrete düşürmek	to surprise	verb					
hayvan	animal	noun					
hazır	ready	adj					
hazır bulunma	availability	noun					
haziran <Haz., Hz., H>	June	noun					
hazne	case	noun					
hazret	excellency	noun					
hecelemek	to spell	verb					
hedef	aim	noun					
hedef	target	noun	hedef almak: to target				
hedef	goal	noun					
hedef	target	noun					
hedefe oturmak	to hit	verb					
hediye	gift	noun					
hediye	present	noun					
hekim	doctor	noun					
hekim	physician	noun					
hekimin hastası	patient	noun					
helikopter	helicopter	noun					
hem	also	adv					
hem de	also	adv					
hem de	even	adv					
hemen	at once	adv					
hemen	immediately	adv					
hemen	in a moment	adv					
hemen hemen	almost	adv					
hemfikir olmak	to agree	verb					
hemşire	nurse	noun					
hemşire	nurse [female]	noun					
henüz	yet	adv					
henüz	just	adv					
henüz değil	not yet	adv					
hep	always	adv					
hepsi	all	adj					
hepsi	everything	pron					
hepsinden önce	above all	adv					
her	all	adj					
her	each	pron					
her	every	pron					
her ay	monthly	adv					
her gün	every day	adv					
her ikisi	both	phrase					
her sene	annual	adj					
her şeyden evvel	above all	adv					
her şeyden önce	above all	adv					
her tarafında	throughout [everywhere]	adv					
her tarafta	throughout [everywhere]	adv					
her yerde	anywhere	adv					
her yerde	throughout [everywhere]	adv					
her yerinde	throughout [everywhere]	adv					
her yıl	annual	adj					
her zaman	anytime	adv					
her zaman olduğu gibi	as always	phrase					
her zamanki gibi	as always	phrase					
herhalde	presumably	adv					
herhalde	in any case	adv					
herhangi	any	pron					
herhangi	any [noun qualifier]	pron					
herhangi bir	any	phrase					
herhangi bir	any [noun qualifier]	phrase					
herhangi bir şey	something	pron					
herhangi bir zaman	ever	adv					
herhangi biri	anyone	pron					
herif	guy	noun					
herif	guy [coll.]	noun					
herkes	everybody	pron					
herkes	everyone	pron					
herkes için	for all	phrase					
hesaba katmak	to take sth. into account	verb					
Hesabı lütfen!	The bill please! [Br.]	phrase					
hesap	account	noun	hesap lütfen! account please!	hesap verirsin: you will be held accountable			
hevesli	eager	adj					
heybet	majesty	noun					
heyecan	excitement	noun					
heyecan verici	exciting	adj					
heyecanlı	excited	adj					
heyecanlı	exciting	adj					
heykel	statue	noun					
hiç	none	pron					
hiç	at all	adv					
hiç	ever	adv					
hiç	never	adv					
hiç [+negation]	not at all	adv					
hiç bir suretle	in no case	adv					
Hiç bir suretle!	Out of the question!	phrase					
hiç kimse	nobody	pron					
hiç olmazsa	at least	adv					
hiçbir şey	nothing	pron					
hiçbir zaman	never	adv					
hiçbiri	nobody	pron					
hıçkırık	hiccup	noun					
hıçkırık	hiccough	noun					
hıçkırık	hiccup	noun					
hiddet	rage	noun					
hiddet	anger	noun					
hidralazin [C8H8N4]	hydralazine	noun					
hidrosfer	hydrosphere	noun					
hikmet	wisdom	noun	hikmet yumurtmak: to spread wisdom				
hileli	dishonest	adj					
hırsız	burglar	noun					
hırsızlık	theft	noun					
hırslı	ambitious	adj					
his	feeling	noun					
hışıltı	wheeze	noun					
hissetmek	to feel	verb					
histoloji	histology	noun					
Hitler oyuncağımı çaldı	When Hitler Stole Pink Rabbit [Judith Kerr]	phrase					
hıyar	cucumber [Cucumis sativus L.]	noun					
hız	speed	noun					
hızla	quickly	adv					
hızlı	fast	adj					
hızlı	quick	adj					
hızlı	rapid	adj					
hizmet	service	noun					
hobi	pastime	noun					
Hollanda	Netherlands	noun					
hoplamak	to hop	verb					
hor görmek	to scorn	verb					
horlamak	to snore	verb					
horoz	cock	noun					
hortum	hose	noun					
hoş	pleasant	adj	hoşça kalın: goodbye				
hoş	amiable	adj					
hoş	nice	adj					
hoş	pleasant	adj					
hoş	welcome	adj					
Hoşça kal!	Goodbye!	phrase					
Hoşçakal!	Cheerio!	phrase					
hoşlanmak	to like	verb					
hoşnut	satisfied	adj					
hoşnut etmek	to please	verb					
hoşuna gitmek	to please	verb					
hücum	attack	noun	hücum etmek: to attack				
hücum açısı	angle of attack	noun					
hücum kenarı	leading edge	noun					
hukukçu	lawyer	noun					
hükumet	government	noun					
Humboldt pengueni [Spheniscus humboldti]	Humboldt penguin	noun					
hür	free	adj					
hurma	date	noun					
hürmet	reverence	noun					
hürriyet	freedom	noun					
hürriyet	liberty	noun					
husus	subject	noun					
hususi	private	adj					
huzursuz etmek	to disturb	verb					
i hali	accusative	noun					
ibik	crest	noun					
İbranice	Hebrew	noun					
ibre	needle	noun					
iç	inside	noun	içinde: in the inside of sg	içini dışına çevirmek: to turn inside out			
iç	drink	noun					
iç gezegen	inner planet	noun					
içecek	drink	noun					
içeri gelmek	to step in	verb					
içeriye	into	prep					
içermek	to contain	verb					
içgüdü	instinct	noun					
içi	inside	adv					
içi boş	hollow	adj					
için	for	prep					
içinde	inside	adv					
içinden	out of	prep					
içinden	through	prep					
içine	into	prep					
içki mahmurluğu	hangover [aftereffects of drunkenness]	noun					
içmek	to drink	verb				
idam cezası	death penalty	noun					
idareli harcamak	to save	verb					
iddia	claim	noun	iddia etmek: to claim				
iddia	argument	noun					
iddialı	sophisticated	adj					
idrak etmek	to grasp	verb					
ifade	expression	noun							
iflas ettirmek	to bankrupt	verb					
iğdiş etmek	to castrate	verb					
iğne	needle	noun					
iğne	pin	noun					
iğrenç	disgusting	adj					
iğrenme	disgust	noun					
ihanet etmek	to betray	verb					
ihbar	notice	noun					
ihtimal	possibility	noun					
ihtivâ etmek	subsume	verb					
ihtiyaç	need	noun	ihtiyaç duymak: to need	ihtiyacı olmak: to be in need of			
ihtiyacı olmak	to need	verb					
ihtiyar	old	adj					
ikamet etmek	to live [in a building/at a place]	verb					
iken	during	prep					
iki	two	noun					
iki bin	two thousand	noun					
iki yüz	two hundred	noun					
ikili	couple	noun					
ikiz paradoksu	twin paradox	noun					
ikon	icon	noun					
ilaç	medicine	noun					
ilan tahtası	notice board	noun					
ilave etmek	to add	verb					
ilaveten	in addition	adv					
ilçe	district	noun					
ile	with <w/>	prep					
ileri	forward	adj	ileriye doğru: forward	ileri sürmek: to assert			
ileri gitmek	to exceed	verb					
ileriye	forward	adv					
ilerlemek	to advance	verb					
ilerletmek	to improve	verb					
iletilmek	to be forwarded	verb					
iletmek	to forward	verb					
ilgeç	grammatical particle	noun					
ilgi	interest	noun	ilgili: relating to				
ilgilendirmek	to concern	verb					
ilginç	interesting	adj					
ilişki	relationship	noun	uluslararası ilişkiler: international affairs				
ilk	first	adv					
ilk olarak	in the first place	adv					
ilkbahar	spring [season]	noun					
ilkokul	primary school	noun					
illegal	illegal	adj					
imalathane	workshop	noun					
imam	imam	noun					
imdadına yetişmek	to help	verb					
imdat	help	noun					
imha etmek	to destroy	verb					
imkansız	impossible	adj					
imtihan	exam	noun					
imza	signature	noun					
in hali	genitive	noun					
inanç	belief	noun					
inanç	faith	noun					
inanılmaz	incredible	adj					
inanmak	to believe	verb					
inatçı	stubborn	adj					
ince	thin	adj	ince eleyip sık dokumak: to scrutinize				
ince	fine	adj					
ince	thin	adj					
incecik	very thin	adj	incecik yapılı: slender				
inceleme	examination	noun					
incelemek	to analyze	verb					
incelikle	subtly [lightly]	adv					
incitmek	to insult	verb					
inek	cow	noun					
İngiliz	English <Eng. / Engl.>	adj					
İngiltere	England	noun					
inlemek	to moan	verb					
inletmek	to moan	verb					
inmek	to land	verb					
inşa etmek	to build	verb					
inşaat	construction	noun					
insaflı	fair	adj					
inşallah	hopefully	adv					
insan	person	noun	insan onuru: human dignity				
insan	human being	noun					
insanlar {pl}	people {pl}	noun					
insanlık	humanity	noun	insanlık dışı: inhuman				
intibak	adaptation	noun					
intikal	transition	noun	intikal etmek: to transfer to				
intikam	revenge	noun	intikam almak: to take revenge				
intoksikasyon	intoxication	noun					
ip	rope	noun	ipe dizmek: to string on				
ipek	silk	noun					
iridyum <Ir>	iridium <Ir>	noun					
ırkçı	racist	adj					
ırkçı	racist	noun					
İrlanda	Ireland <.ie>	noun					
ırmak	river	noun					
iş	work	noun	işe son vermek: to quit work				
iş	employment	noun					
iş	job	noun					
iş	work	noun					
iş parçacığı	thread	noun					
isabet	hit	noun					
isabet etmek	to hit	verb					
işaret	sign	noun					
işaret parmağı	forefinger	noun					
işçi	employee	noun					
işe alma	employment	noun					
işgal	occupation	noun	işgal etti: occupied				
işgal altında	occupied	adj					
işgal edilmiş	occupied	phrase					
ishal	diarrhea	noun					
ışık	light	noun					
ışık yılı <IY>	light year <ly>	noun					
ışıldamak	to shine	verb					
ışıldamak	to glint	verb					
isim	name	noun	isminiz ne? what is your name?	isimli: named, called			
İşin içinde iş var mı?	What's the catch?	phrase					
ısınmak	to become warm	verb					
ısıtmak	to warm up sg	verb					
işitmek	to hear	verb					
İskoçya	Scotland	noun					
ıslak	wet	adj					
İslam	Islam	noun					
ıslanmak	to get wet	verb					
işlem	operation	noun					
işlem	procedure	noun					
işlemek	to work	verb					
isli doğan [Falco concolor]	sooty falcon	noun					
ısmarlamak	to order	verb					
İsmin ne?	What's your name?	phrase					
İspanya	Spain <.es>	noun					
İspanya	Spanish	adj					
İspanyol	Spanish	adj					
ispat	proof	noun					
ispatlamak	to prove	verb					
ıssız	deserted	adj	ıssız ada: desert island				
iştah açıcı	aperitive	noun					
istasyon	train station	noun					
işte	here	phrase					
İşte bu!	Way to go!	phrase					
istekli	eager	adj					
isteksiz	reluctant	adj					
istemeden	unintentionally	adv					
istemek	to ask for	verb					
istemek	to require	verb					
istemek	to want (to)	verb					
istemek	to wish	verb					
istif etmek	to stack	verb					
istifa	resignation	noun					
istifa etmek	to resign	verb					
istihtam etme	employment	noun					
istikbal	future	noun					
istikbâlde	hereinafter	adv					
İsviçre	Switzerland <.ch>	noun					
it [kaba]	mutt [coll.] [dog, mongrel]	noun					
itaatkar	submissive	adj					
İtalya	Italy <.it>	noun					
İtalyan	Italian [person from Italy]	adj					
itfaiye	fire brigade [esp. Br.]	noun					
itfaiyeci	fireman	noun					
itikat	belief	noun					
itiraf etmek	to admit	verb					
itiraz etmek	to disagree	verb					
itmek	to push	verb					
ittifak	unity	noun					
iyi	good	adj	en iyi: best				
iyi	all right	adv					
iyi	fine	adj					
iyi	good	adj					
İyi akşamlar!	Good evening!	phrase					
İyi geceler!	Good night! <Gn8>	phrase					
İyi günler!	Good afternoon!	phrase					
İyi günler!	Good day! [Br.]	phrase					
iyi ki	fortunately	adv					
İyi şanslar!	Good luck!	phrase					
iyice kızarmış	well done [gastronomy]	adj					
iyileşmek	to recover	verb					
iyileştirmek	to improve	verb					
İyiyim.	I am OK.	phrase					
ızgara	grilled	adj					
ızgara	barbecue	noun					
ızgara	grill	noun					
ızgara	manhole cover	noun					
izin	permission	noun	izin vermek: to allow				
izin	holiday [esp. Br.]	noun					
izin	permission	noun					
izin	permit	noun					
izin vermek	to allow	verb					
izin vermek	to give permission	verb					
izinli	allowed	adj					
jambon	ham	noun					
Japon	Japanese	adj					
Japonya	Japan <.jp>	noun					
jeofizik	geophysics [treated as sg.]	noun					
jeomorfoloji	geomorphology	noun					
jilet	razor blade	noun					
jinekoloji	gynaecology [Br.]	noun					
jinekoloji	gynecology [Am.]	noun					
kaba	rude	adj					
kaba	unfriendly	adj					
kabahat	fault	noun					
kabak	courgette [Br.]	noun					
kabin basıncı	cabin pressure	noun					
kabin basınçlandırması	cabin pressurization	noun					
kabin tazyîki	cabin pressure	noun					
kabızlık	constipation	noun					
kablo	cable	noun					
kabuk	peel	noun					
kabuk	shell	noun					
Kabul ediyorum.	I agree.	phrase					
kabullenmek	to accept	verb					
kaburga	frame	noun					
kâbus	nightmare	noun					
kaç tane	how many	phrase					
Kaç yaşındasın?	How old are you?	phrase					
kaçak	smuggled	adj					
kaçınmak	to avoid	verb					
kaçınmak	to beware	verb					
kaçmak	to escape	verb					
kaçmak	to run away	verb					
kadar	to	prep					
kadar	until	conj					
kadar [süre]	by	prep					
kadife	velvet	noun					
kadın	woman	noun						
kafa	head	noun					
kafa	head [Caput]	noun					
kafalı	bright	adj					
kafalı	intelligent	adj					
kafası karışmış	confused	phrase					
kafatası	skull	noun					
kafaya takma	obsession	noun					
kağıt	paper	noun					
kağıt mendil	tissue	noun					
kağıt peçete	napkin	noun					
kahraman	hero	noun					
kahvaltı	breakfast	noun					
kahvaltı büfesi	breakfast buffet	noun					
kahve	coffee	noun					
kahverengi	brown	adj					
kahverengi doğan [Falco berigora]	brown falcon	noun					
kahverengi pelikan [Pelecanus occidentalis]	brown pelican	noun					
kalabalık	crowd	noun					
kalan	left [remaining]	adj					
kalan	residual	adj					
kalaylamak	to (coat with) tin	verb					
kalaylamak to swear at sb. [sl.]	verb					
kalça	hip [Coxa]	noun					
kaldırma	lift	noun					
kaldırmak	to remove	verb					
kaldırmak	to carry	verb					
kaldırmak	to take off [to remove]	verb					
kale	castle	noun					
kalem	pencil	noun					
kalem	pen	noun					
kalfa	journeyman	noun					
kalıcı	residual	adj					
kalın	thick	adj					
kalın	fat [thick]	adj				
kalıntı	residue	noun					
kalkan	shield	noun					
kalkış	take-off	noun					
kalkmak	to lift	verb					
kalkmak	to get up	verb					
kalkmak	to leave	verb					
kalmak	to stay	verb					
kalp	heart	noun	kalbimde: in my heart				
kalsit	calcite	noun					
kaltak [kaba]	whore	noun					
Kalvinizm	Calvinism	noun					
Kamboçya	Cambodia	noun					
kamera	camera	noun					
kameralizm	cameralism	noun					
kamp yeri	camping site	noun					
kamyon	truck	noun					
kamyonet	van	noun					
kan	blood	noun	kan kardeş: blood brother				
Kanadalı	Canadian	noun					
kanat	wing	noun					
kanatçık	aileron	noun					
kanımca	in my opinion <IMO>	adv					
kanıt	evidence	noun					
kanıt	proof	noun					
kanıtlamak	to prove	verb					
kanka	bro	noun					
kanser	cancer	noun					
kanun	law	noun					
kanyak	brandy	noun					
kap	container	noun					
kap	cover	noun	kaplı: covered				
kap	case	noun					
kapatmak	to switch off	verb	kapatın şunu: turn it off				
kapatmak	to close	verb					
kapı	door	noun					
kapı kilidi	lock [on a door]	noun					
kapkara	jet black	adj					
kaplan	tiger	noun					
kapmak	to catch	verb					
kaporta	skin	noun					
kapsam	scope	noun					
kapsamak	to contain	verb					
kapuçino	cappuccino	noun					
kar	snow	noun					
kar baykuşu [Bubo scandiacus, syn.: Nyctea scandiaca]	snowy owl	noun					
kar payları	dividends {pl}	noun					
kar tanesi	snowflake	noun					
kara	shore	noun	karadan: by land				
kara	dark	adj					
kara	black	adj	Karadeniz: Black Sea				
kara	dark	adj					
kara ağaçkakan [Dryocopus martius]	black woodpecker	noun					
kara alınlı örümcek kuşu [Lanius minor]	lesser gray shrike [Am.]	noun					
kara başlı çinte [Emberiza melanocephala]	black-headed bunting	noun					
kara başlı kiraz kuşu [Emberiza melanocephala]	black-headed bunting	noun					
kara dalıcı martı [Cepphus grylle]	black guillemot	noun					
kara gerdanlı dalgıç [Gavia arctica]	Arctic loon [Am.]	noun					
kara kızılkuyruk [Phoenicurus ochruros]	black redstart	noun					
kara leylek [Ciconia nigra]	black stork	noun					
kara mamba [Dendroaspis polylepis]	black mamba	noun					
kara sırtlı çakal [Canis mesomelas]	black-backed jackal	noun					
karabaş çinte [Emberiza melanocephala]	black-headed bunting	noun					
karabaş kiraz kuşu [Emberiza melanocephala]	black-headed bunting	noun					
karabaş ötleğen [Sylvia atricapilla]	(Eurasian) blackcap	noun					
Karadeniz	Black Sea	noun					
karakulak [Caracal caracal]	caracal	noun					
karanfil [baharat]	cloves {pl}	noun					
karanlık	dark	adj					
karanlık enerji	dark energy [cosmology]	noun					
karanlık madde	dark matter [cosmology]	noun					
karantina	quarantine	noun					
karar	decision	noun	yakalama kararı: arrest warrant				
karar vermek	to decide	verb					
kararlaştırmak	to agree	verb					
kararlı	determined	adj					
kararmak	to darken	verb	iç karartmak: to depress				
kararsız	hesitant	adj					
karavan	van	noun					
karavel	caravel	noun					
karayel	northwester	noun					
karbonhidrat	carbohydrate	noun					
kardeş	brother <bro.>	noun					
kardeşler {pl}	siblings {pl}	noun					
kardiyoloji	cardiology	noun					
kare	square	noun					
karı	wife	noun					
karın	belly	noun					
karınca	ant	noun					
karışık	miscellaneous	adj					
karışık	mixed	adj					
karışık salata	mixed salad	noun					
karışıklık	confusion	noun					
karıştırıcı	mixer	noun					
karmaşık sayı	complex number	noun					
karnabahar	cauliflower	noun					
karpuz	watermelon	noun					
karpuz	melon	noun					
karşısında	opposite	prep					
karşı	against	adv	bu suale karşı: against this question				
karşı	opposite	adv					
karşıdan karşıya	across	adv					
karşılamak	to welcome	verb					
karşılanmak	to be met	verb	hoş karşılanmak: to welcome				
karşılaştırma	comparison	noun					
karşılaştırmak	to compare	verb					
karşılıklı	mutual	adj					
karşın	in spite of	prep					
karşıt	opposite	noun					
karşıya	across	adv					
kart	card	noun					
kartal	eagle [bird]	noun					
kartografya	cartography	noun					
kartpostal	postcard	noun					
kas	muscle [Musculus]	noun					
kaş	eyebrow	noun					
kasap	butcher	noun					
kâse	bowl	noun					
kaşık	spoon	noun					
kasım <kas., ks., k.>	November <Nov.>	noun					
kasıtlı	on purpose	adv					
kasket	cap	noun					
kaşkol	scarf	noun					
kastanyet	castanet	noun					
kasten	on purpose	adv					
kastetmek	to mean	verb					
kat	floor	noun					
katakomp	catacomb	noun					
katalizatör	catalyst	noun					
kataloglamak	to catalogue	verb					
katatoni	catatonia	noun					
katedral	cathedral	noun					
kategori	category	noun					
katil	assassin	noun					
katıl	killer	noun	katıla gülmek: to laugh out loud				
katılmak	to agree	verb					
katılmak	to take part	verb					
katiyen	never	adv	katiyen olmaz! no way!				
katkı	contribution	noun					
katliam	massacre	noun					
katma değer vergisi <KDV>	value added tax <VAT>	noun					
katmak	to add	verb					
Katolik	Catholic <Cath, C>	adj					
kaval kemiği	shin	noun					
kavga	fight	noun					
kavga	quarrel	noun					
kavga etmek	to argue	verb					
kavga etmek	to fight	verb					
kavram	notion	noun					
kavramak	to grasp	verb					
kavramak	to understand	verb					
kavun	melon	noun					
kayısı	apricot	noun					
kaya kiraz kuşu [Emberiza cia]	rock bunting	noun					
kayabaşı	folk song	noun					
kaybetmek	to lose	verb					
kaybı	loss	noun					
kaybolmak	to get lost	verb					
kaybolmak	to vanish	verb					
kaygana	omelette	noun					
kaygı	anxiety	noun					
kaygı	anxiety [worry]	noun					
kaygı	concern [worry]	noun					
kaygı	solicitude	noun					
kaygı	worry	noun					
kaygılı	anxious	adj					
kayık	boat	noun					
kayınpeder	father-in-law	noun					
kayınvalide	mother-in-law	noun					
kayıp	lost	adj					
kayıt	record	noun	kayıt altına almak: to record				
kaymak	to slip	verb	kızak kaymak: to slide, toboggan				
kaynana	mother-in-law	noun					
kaynana-kaynata	parents-in-law	noun					
kaynata	father-in-law	noun					
kaz	goose	noun	kaz ayaklar: crow's feet (around one's eyes)				
Kazak	Kazakh	noun					
kazak	sweater	noun					
kazanç	revenue	noun					
kazanmak	to win	verb					
kazanmak	to earn [money]	verb					
kazarmak	to dig	verb					
keçi	goat	noun					
kedi	cat	noun					
kefen	shroud	noun					
kek	cake	noun					
kelebek	butterfly	noun					
kelime	word	noun					
kemer	belt	noun					
kemik	bone	noun					
kemikler {pl}	bones	noun					
kemirmek	to gnaw	verb					
kemoterapi	chemotherapy	noun					
kenar	edge	noun					
kenar çekmek	to edge	verb					
kenara çekmek	to pull over	verb					
kenarı	edge	noun					
kendi	self	pron					
kendileri	themselves [direct / indirect object]	pron					
kendinden geçmek	to pass out	verb					
kendine güvenen	self-confident	adj					
kendini	herself	pron					
kendini	yourself	pron					
kendini beğenmiş	conceited	adj					
kendini geliştirmek	to improve oneself	verb					
kerata	rascal	noun					
kerevit	crayfish	noun					
kereviz	celery	noun					
kerkenez	kestrel	noun					
Kes şunu!	Drop it!	phrase					
keşfetmek	to discover	verb					
keşfetmek	to find [discover, detect]	verb					
keşif	exploration	noun					
kesilmiş	chopped	adj					
kesin	sure	adj					
kesin	certain	adj					
kesin	exactly	adv					
kesinlikle	definitely	adv					
kesinlikle	Out of the question!	phrase					
keşişleme	southeaster	noun					
keşke	if only	conj					
keskin	sharp	adj					
kesmek	to cut	verb					
kesmek	to turn off	verb					
kestane [rengi]	chestnut brown	adj					
kestane ağacı	chestnut [tree]	noun					
kestirmek	to estimate	verb					
keyif	convenience	noun					
keyif vermek	to please	verb					
keza [hukuk]	likewise	adv					
kibar	gentle	adj					
kibar	polite	adj					
kibarca	kindly	adv					
kibirli	arrogant	adj					
kibirli	conceited	adj					
kıç	ass	noun					
kiler	cellar	noun					
kılıf	cover	noun					
kilise	church	noun					
kilit [kapıda]	lock [on a door]	noun					
kilitlemek	to lock	verb					
kılkuyruk [Anas acuta]	(northern) pintail	noun					
kilometre	kilometer [Am.] <km>	noun					
kim	who	pron					
Kim var orada?	Who is there?	phrase					
kime	to whom	pron	kime diyorum? who am i calling?	kimi arıyorsun? who are you looking for?			
kime	whom	pron					
kımıldamak	to move	verb					
kımıldatmak	to move	verb					
kimin	whose	pron					
kimse	noone	pron					
kimse	person	noun					
kimya	chemistry	noun					
kimyasal	chemical	adj					
kin	hate	noun					
kinestetik	kinesthetic	adj					
kinetik	kinetic	adj					
kır	field	noun					
kır incir kuşu [Anthus campestris]	tawny pipit	noun					
kiracı	tenant	noun					
kiralamak	to rent	verb					
kırarcasına	vehemently	adv					
kiraz	cherry	noun					
kırçıl marmot [Marmota caligata]	hoary marmot	noun					
kiremit	tile	noun					
Kırgız	Kyrgyz	noun					
kiriş	beam	noun					
kırışık	wrinkle	noun					
kırk	forty	noun					
kırlangıç	swallow	noun					
kirli	dirty	adj					
kırmak	to hurt	verb					
kırmak	to break	verb					
kırmızı	red	adj					
kırmızı turp	radishes {pl}	noun					
kirpi	hedgehog	noun					
kirpik	eyelash	noun					
kırsal	rural	adj					
kış	winter	noun					
kısa	short	adj					
kısa	quick	adj					
kısa	short	adj					
kısa pantolon	shorts	noun					
kısaca	briefly	adv					
kısım	portion	noun	bu kısımda: at this point				
kişisel	self	pron					
kıskanç	jealous	adj					
kıskanç olmak	to be jealous	verb					
kısmen	partially	adv					
kısmet	luck	noun					
kısmet	fortune	noun					
kitap	book	noun					
kıvam	temper	noun					
kıyafet	dress	noun					
kıyı	coast	noun					
kıyı	edge	noun					
kıyıya	ashore	adv					
kıyma	mincemeat	noun					
kıymet	value	noun					
kıymetli	precious [valuable]	adj					
kıymetli	substantial [valuable]	adj					
kıymetli	treasured	adj					
kıymetli	valuable	adj					
kız	girl	noun					
kız arkadaş	girlfriend	noun					
kız evlat	daughter	noun					
kız kardeş	sister	noun					
kız torun	granddaughter	noun					
kız yeğen	niece	noun					
kızak	sled	noun	kızak kaymak: to slide, toboggan				
kızgın	angry	adj					
kızgınlık	rage	noun					
kızıl	red	adj	Kızıldeniz: Red Sea				
kızıl ardıç kuşu [Turdus iliacus]	redwing [thrush]	noun					
kızıl boyunlu batağan [Podiceps grisegena]	red-necked grebe	noun					
kızıl enseli doğan [Falco pelegrinoides]	Barbary falcon	noun					
kızıl gerdanlı dalgıç [Gavia stellata]	red-throated diver [Br.]	noun					
kızıl gerdanlı dalgıç [Gavia stellata]	red-throated loon [Am.]	noun					
kızıl kum kuşu [Calidris ferruginea]	curlew sandpiper	noun					
Kızıldeniz	Red Sea	noun					
kızılgerdan [Erithacus rubecula]	(European) robin	noun					
kızlar {pl}	girls	noun					
klarnet	clarinet	noun					
klasik müzik	classical music	noun					
klasör	folder	noun					
klavsen	harpsichord	noun					
koala [Phascolarctos cinereus]	koala	noun					
koca	husband	noun					
kocaman	huge	adj					
kodes [argo]	jailhouse [sl.]	noun					
koherent	coherent	adj					
kohezif	cohesive	adj					
kök	root	noun					
koklamak	to smell	verb					
kokmak	to smell	verb					
kökten dinci	fundamentalist	phrase					
koku	perfume	noun					
koku	smell	noun					
kol	arm	noun					
kol saati	watch [wristwatch]	noun					
kolay	easy	adj					
kolay anlaşılır	coherent	adj					
Kolay gelsin!	Good luck! [wishing success]	phrase					
kolon	column	noun					
kolonoskopi	colonoscopy	noun					
kolye	necklace	noun					
kolyeli büyük yağmurcun [Charadrius hiaticula]	(common) ringed plover	noun					
komedyen yardakçısı	stooge	noun					
kompleks sayı	complex number	noun					
kompresör	compressor	noun					
komşu	neighbor	noun	komşu kız: girl next door				
komşu	neighbor [Am.]	noun					
kömür	coal	noun					
konak	mansion	noun					
kondurmak	to put	verb					
konforlu	comfortable	adj					
konser	concert	noun					
konu	issue	noun					
konu	topic	noun					
konuk	guest	noun					
konuk eden kimse	host	noun					
konum	location	noun					
konum	place	noun					
konum	position	noun					
konum	status	noun					
konuşma	speech	noun					
konuşmak	to speak	verb					
konuşmak	to talk	verb					
konusunda	regarding	phrase					
konyak	brandy	noun					
koparmak	to tear off	verb					
köpek	dog	noun					
kopmak	to break (off)	verb					
köprü	bridge	noun					
kopyalamak	to copy	verb					
koreografi	choreography	noun					
körfez	bay	noun					
Korkarım ki ...	I'm afraid ...	phrase					
korku	dread [horror]	noun					
korku	fear	noun					
korku	horror	noun					
korku	scare [horror]	noun					
korku	thrill [horror]	noun					
korku	trepidation	noun					
korkunç	awful	adj					
korkunç	horrible	adj					
korkunç	scary [coll.]	adj					
korkunç [argo]	awesome [Am.] [coll.]	adj					
korkutucu	scary [coll.]	adj					
korkuymak	to be afraid	verb					
koru	woods	noun					
koruma	bodyguard	noun					
koşan	running	adj					
köşebent	bracket	noun					
koşmak	to run	verb	dörtnala koşmak: to gallop				
kostüm	costume	noun					
kötü	bad	adj	o kadar kötü olamaz: it can't be that bad				
kötü	evil	adj					
kötü niyetle	falsely	adv					
kötü niyetle	maliciously	adv					
kötü niyetle	wickedly	adv					
kötü niyetle	wrongly	adv					
kötü şekilde	negatively [adversely]	adv					
kötü yönde	negatively [adversely]	adv					
kötülemek	to discredit	verb					
kötülemek	to disparage	verb					
kötülemek	to malign	verb					
kötülemek	to vilify	verb					
kötüleyici	pejorative	adj					
kötümserlik	pessimism	noun					
kötümserlikle	negatively [in a pessimistic way]	adv					
kova	bucket	noun					
kovalamak	to chase	verb					
kovboy	cowboy	noun					
kovmak	to fire	verb					
kovmak	to dismiss	verb					
köy	village	noun					
koymak	to put	verb					
koymak	to place	verb					
koymak	to put	verb					
koymak	to set down	verb					
koyu	dark	adj					
koyu mavi	dark blue	adj					
koyun	sheep	noun					
koyun	bosom	noun					
koyungözü [Bellis perennis]	daisy	noun					
koza	cocoon	noun					
kozağaç	fir tree	noun					
kral	king	noun					
Kral Lear	King Lear [William Shakespeare]	phrase					
kraliçe	queen	noun					
kraliyet düğünü	royal wedding	noun					
kravat	tie	noun					
krema	cream	noun					
kriket	cricket	noun					
kuaför	hairdresser	noun					
kuantum kimyası	quantum chemistry	noun					
kucanmak	to embrace	verb					
küçücük	tiny	adj					
küçük	little	adj					
küçük	small	adj					
küçük düşürmek	to humiliate	verb		
küçük halı	rug	noun					
küçük kerkenez [Falco naumanni]	lesser kestrel	noun					
küçük kiraz kuşu [Emberiza pusilla]	little bunting	noun
küçültmek	to minimize	verb					
küçümsemek	to despise	verb					
Kudüs	Jerusalem	noun					
kukumav	little owl	noun					
kül tabla	ashtray	noun					
kül tablası	ashtray	noun					
kulak	ear	noun					
kule	tower	noun					
kullanışlı	convenient	adj					
kullanışlı	handy	adj					
kullanmak	to apply	verb					
kullanmak	to drive	verb					
kullanmak	to use	verb					
küllük	ashtray	noun					
kulüp	club	noun					
kum	sand	noun					
kum fırtınası	sandstorm	noun					
kum saati yunusu [Lagenorhynchus cruciger]	hourglass dolphin	noun					
kumar	gamble	noun					
kumar oynamak	to gamble	verb					
kumaş	fabric	noun					
kümbet	cupola [dome]	noun					
kümbet	dome	noun					
kumpas	vernier caliper	noun					
kumsal	beach	noun					
kupa	cup	noun					
kupa	mug	noun					
kural	rule	noun					
kurallı	regular	adj					
kürk	fur	noun					
kurnaz	cunning	adj					
kurnazca	on the sly	adv					
kurşunkalem	pencil	noun					
kurt [Canis lupus]	wolf	noun					
kurtarmak	to save	verb					
kurtarmak	to help	verb					
kurtarmak	to save [rescue]	verb					
kuru	dry	adj					
kuru temizleme	dry cleaner's	noun					
kurul	board	noun					
kurumak	to dry	verb					
kurutmak	to dry up	verb					
kurutmak	to dry	verb					
kuş	bird	noun					
kuşkonmaz	asparagus [Asparagus officinalis]	noun					
kuşkulanmak	to doubt	verb					
kuşkusuz	certainly	adv					
kuşkusuz ki	indeed	adv					
kusmak	to vomit	verb					
kusmuk	vomit	noun					
küstah	arrogant	adj					
küstah	cheeky	adj					
kusur	mistake	noun	kusura bakma: sorry				
Kusura bakmayın!	Excuse me!	phrase					
kusursuz	excellent	adj					
kutlama	celebration	noun					
kutlamak	to celebrate	verb					
kütleçekimsel çökme	gravitational collapse	noun					
kutsal	sacred	adj					
kutu	box [jewellery box, on newspaper page etc.]	noun					
kutu	can	noun					
kutup ayısı [Ursus maritimus]	polar bear	noun					
kütüphane	library	noun					
kütüphaneci	librarian	noun					
kuvvet	force	noun					
kuvvet	power	noun					
kuvvetli	strong	adj					
kuyruk	tail	noun					
kuyruklu yıldız	comet	noun					
kuyruklu yıldız	shooting star	noun					
kuyrukta beklemek	to line up	verb					
kuyu	well	noun					
kuzen	cousin	noun					
kuzey	north	noun					
Kuzey Kutbu	North Pole	noun					
kuzguni	raven [color]	adj					
kuzguni siyah	jet-black	adj					
kuzin	cousin [female]	noun					
kuzu	lamb	noun					
kuzu eti	lamb	noun					
Kuzuların Sessizliği	The Silence of the Lambs [novel: Thomas Harris; film: Jonathan Demme]	phrase					
laf	word	noun					
lahza	instant	noun					
lahza	moment	noun					
lakin	but	conj					
lakin	however	conj					
lâkin	nevertheless	adv					
laktoz	lactose	noun					
lale	tulip	noun					
lamba	lamp	noun					
lambası	blinker	noun					
lânet	curse	noun					
lânet	imprecation	noun					
lapa	mush	noun					
lapa	pulp	noun					
lastik	tyre [Br.]	noun					
lastikli	ambiguous	adj					
lastikli	elastic	adj					
layık	worthy	adj					
lazer	laser	noun					
lazım	necessary	adj					
leğen	bowl	noun					
leke	stain	noun					
lenf	lymph	noun					
lenfatik sistem	lymphatic system	noun					
lenfatik sistem	lymph system	noun					
leopar [Panthera pardus]	leopard	noun					
lepton	lepton	noun					
Letonyalı	Latvian	noun					
leylek	stork	noun					
lezzetli	delicious	adj					
liberalizm	liberalism	noun					
lider	leader	noun					
lif	fibre [Br.]	noun					
lig	league	noun					
limnoloji	limnology	noun					
limon	lemon	noun					
linç	lynching	noun					
lisan	language <lang.>	noun					
liste	list	noun					
lityum florür [LiF]	lithium fluoride	noun					
lityum hidroksit [LiOH]	lithium hydroxide	noun					
lodos	southwester	noun					
lokanta	restaurant	noun					
lokatif	locative	noun					
loş	shady	adj					
Lütfen!	Please!	phrase					
lüzum	necessity	noun					
lüzumlu	necessary	adj					
mısır	corn [Zea mays] [Am.] [Aus.] [NZ]	noun					
Mısır	Egypt <.eg>	noun					
maalesef	unfortunately	adv					
maaş	salary	noun					
Macar	Hungarian	adj					
Macaristan	Hungary <.hu>	noun					
macera	adventure	noun					
madde	substance	noun					
madde	item	noun					
madde	matter	noun					
maddeleştirmek	to reify	verb					
madem	since	conj					
maden suyu	mineral water	noun					
madeni para	coin	noun					
madensuyu	mineral water	noun					
mahalli saat	local time	noun					
mahçup	shy	adj					
mâhirâne	subtle	adj					
mahmuzlu çinte [Calcarius lapponicus]	Lapland bunting	noun					
mahmuzlu çinte [Calcarius lapponicus]	Lapland longspur	noun					
mahrem	secret	adj					
mahrum bırakmak	forego	verb					
mahvetmek	to ruin	verb					
maikong [Cerdocyon thous]	common fox	noun					
makale	article	noun					
makarna	noodles	noun					
makarna	pasta	noun					
makas	scissors	noun					
maksat	purpose	noun					
mal	goods	noun					
mal	property	noun					
malak	buffalo	noun					
maliyet	cost	noun					
maltoz	maltose	noun					
malzeme	material	noun					
mamografi	mammography	noun					
mandalina	tangerine	noun					
mangal	brazier	noun					
mantar	mushroom	noun					
mantıklı	coherent	adj					
manyak	maniac	adj					
manzara	landscape	noun					
Marsilya	Marseille	noun					
martı	seagull	noun					
marul	lettuce	noun					
masa	table	noun					
masum	innocent	adj					
mavi	blue	adj					
mavi baştankara [Cyanistes caeruleus, Parus caeruleus]	(Eurasian) blue tit	noun					
maya	yeast	noun					
mayalamak	to brew	verb					
maydanoz	parsley	noun					
mayıs	May	noun					
maymun	monkey	noun					
mazeret [osm.]	excuse	noun					
mazur görmek	to forgive	verb					
mecbur olmak	to have to	verb					
meçhul	uncertain	adj					
medet	help	noun					
medrese	school	noun					
medya tarihi	media history	noun					
mehtap	moonlight	noun					
mehtaplı	moonlit	adj					
mekan	space	noun					
Meksika	Mexico <.mx>	noun					
mektep	school	noun					
mektup	letter	noun					
melek	angel	noun					
meltem	breeze	noun					
memişhane [osm.]	restroom [Am.]	noun					
memleket	home land	noun					
memleket	home town	noun					
memnun	glad	adj					
memnun	pleased	adj					
memnun	satisfied	adj					
memnun etmek	to please	verb					
Memnun oldum.	Nice to meet you.	phrase					
mendil	handkerchief	noun					
menenjit	meningitis	noun					
menü	menu	noun					
merak	worry	noun	merak etme: don't worry				
merak	concern	noun					
merak etmek	to wonder	verb					
merak etmek	to worry	verb					
meraklı	curious	adj					
meraklı	nosy [coll.]	adj					
merakta kalmak	to worry	verb					
meram	purpose	noun					
mercan resifi	coral reef	noun					
merdiven	ladder	noun					
merdiven	steps	noun					
merdiven	stairs	noun					
Merhaba!	Hello!	phrase					
Merhaba!	Hi!	phrase					
merkez	centre [Br.]	noun					
merkezi	central	adj					
merkezî	central	adj					
mermer	marble	noun					
mermi	bullet	noun					
mertçe	to be honest	adv					
mesafe	distance	noun					
mesaj	message	noun	mesaj atmak: to text				
mesela	for example <e.g.>	adv					
mesele	issue	noun					
meşgale	pastime	noun					
meşgul	busy	adj					
meşgul	occupied	adj					
meşhur	renowned	adj					
meslek	job	noun					
meslek	occupation	noun					
meslek	trade	noun					
mesut	happy	adj					
meteor	meteor	noun					
meteor	shooting star	noun					
methetmek	to laud	verb					
metre	meter <m> [Am.]	noun					
metro	subway [Am.]	noun					
mevcut	available	adj					
mevcut olma	availability	noun					
mevkii	location	noun					
mevsim	season	noun					
mevsimlik	seasonal	adj					
meydan	square	noun	meydana gelmek: to happen				
meydana gelmek	to happen	verb					
meydana getirmek	to create	verb					
meyve	fruit	noun					
meyve salatası	fruit salad	noun					
mezarlık	cemetery	noun					
meze	appetizer	noun					
meze	starter [Br.] [appetizer]	noun					
mezun	graduate	adj					
mide	stomach	noun					
midye	shell	noun					
mikrobiyoloji	microbiology	noun					
mikrodalga	microwave	noun					
mikroişlemci	microprocessor	noun					
miktar	amount	noun					
milyar	billion [Am.]	noun					
milyar	milliard [Br.]	noun					
milyon	million	noun					
mimar	architect	noun					
minare	minaret	noun					
minder	pillow	noun					
Minerva	Minerva	noun					
minibüs	van	noun					
minicik	tiny	adj					
minnettar	thankful	adj					
mintan	shirt	noun					
mirası	inheritance	noun					
misafir	guest	noun	misafir etmek: to host				
misafir	visitor	noun					
misafirlik	visit	noun					
misal	example	noun					
mısır	corn	noun					
misket	marble	noun					
miyozin	myosin	noun					
mizofobi	mysophobia	noun					
mobilya	furniture	noun					
moda	fashion	noun					
modern	modern	adj					
molekül	molecule	noun					
moloz yığını	rubble	noun					
monopol	monopoly	noun					
monosakkarit	Monosaccharide	noun					
mor	purple	adj					
mors [Odobenus rosmarus]	walrus	noun					
motor	engine	noun					
motosiklet	motorcycle	noun					
muallim	teacher	noun
muamele	treatment	noun					
muayene	examination	noun					
muazzam	gigantic	adj					
muazzam	huge	adj					
mücazat [osm.]	punishment	noun					
müddet	duration	noun					
muhakkak	certainly	adv					
mühendis	engineer	noun					
mühendislik	engineering	noun					
mühim	important	adj					
mühletli	temporary	adj					
muhtaç olmak	to require	verb					
muhtemelen	probably	adv					
muhtemelen	perhaps	adv					
muhtemelen	probably	adv					
muhteşem	wonderful	adj					
muhteşem	great	adj					
muhteşem	superb	adj					
müjde	miracle	noun					
müjdeci	herald	noun					
mukavemet	strength	noun					
mükemmel	perfect	adj					
mükemmel	excellent	adj					
mülk	property	noun					
mülteci	refugee	noun					
mum	candle	noun					
mümkün	possible	adj					
münakaşa etmek	to quarrel	verb					
münasebet	relationship	noun					
müsaade	permission	noun	müsaade buyurmak: to give permission				
muska	amulet	noun					
müsli	muesli	noun					
Müslüman	Islamic	adj					
Müslüman	Muslim	noun					
müşter	customer	noun					
müteşekkir	thankful	adj					
mütevazı	humble	adj					
mutfak	kitchen	noun					
müthiş	awesome [coll.] [excellent]	adj					
müthiş	outstanding	adj					
mutlu	glad	adj					
mutlu	happy	adj					
mutlu son	happy ending	noun					
mutluluk	happiness	noun					
mutsuz	unhappy	adj					
mutsuzluk	misery	noun					
mutsuzluk	unhappiness	noun					
muvaffakiyet	success	noun					
muz	banana	noun					
müze	museum	noun					
müzik	music	noun					
müzik kutusu	music box	noun					
muziplik	joke	noun					
N'aber? [konuş.]	What's up? [Am.] [coll.]	phrase					
nadir	seldom	adj					
nakletmek	to tell	verb					
nal	horseshoe	noun					
namus	honour	noun					
namussuz	dishonest	adj					
nanoteknoloji	nanotechnology	noun					
nar	pomegranate	noun					
narsisizm	narcissism	noun					
nasihat	advice	noun					
nasıl	how	adv					
Nasıl gidiyor?	What's up? [Am.] [coll.]	phrase					
nasıl olsa	anyway	adv					
Nasıl oluyor da, ...?	How come ... ?	phrase					
nasılsa	somehow	adv					
Nasılsın?	How's it going?	phrase					
Nasılsın?	How are you?	phrase					
Nasılsın?	How do you do?	phrase					
Nasılsınız?	How are you?	phrase					
Nasılsınız?	How are you doing?	phrase					
naz	affectation	noun					
nazik	gentle	adj					
nazik	polite	adj					
nazikçe	kindly	adv					
ne ... ne de	neither ... nor	conj					
Ne düşünüyorsun?	What do you think?	phrase					
ne kadar	how many	phrase					
ne kadar	how much	adv					
Ne kadar sürecek ... ?	How long will it take ... ?	phrase					
Ne kadar?	How much is it?	phrase					
Ne yapıyor?	How's he doing?	phrase					
ne yazık	What a pity!	phrase					
ne yazık ki	unfortunately	adv					
ne zaman	when	adv					
nebi	prophet	noun					
nede	why	conj	nede olsa: after all				
neden	reason	noun	bunun nedeni: this is because				
neden	why	adv	neden olmasın? why not?				
neden	reason	noun					
neden	why	adv					
nedeniyle	because of	adv					
nedense	for some reason	adv					
nefes	breath	noun					
nefesleme	exhalation	noun					
nefis	delicious	adj					
nefret	hate	noun					
nefret	hatred	noun					
nefret etmek	to hate	verb					
nefret etmek	to loathe	verb					
nefroloji	nephrology	noun					
nekroz	necrosis	noun					
Nemesis	Nemesis	noun					
nemli	moisture	noun					
nemli	wet	adj					
nemli	humid	adj					
nerede	where [interrogative]	adv					
nereden	where ... from	adv					
neredeyse	almost	adv					
neredeyse	nearly	adv					
Nerelisin?	Where are you from?	phrase					
Nerelisiniz?	Where are you from?	phrase					
neşe	joy	noun					
neşelenmek	to cheer up	verb					
Nestoryanizm	Nestorianism	noun					
Nestûrîlik	Nestorianism	noun					
net	net	noun					
netice	conclusion	noun					
netleşmek	to get clear	verb					
neyse	anyway	adv					
neyse	whatever	adv					
nezaketsiz	rude	adj					
niçin	what for	adv					
nihayet	finally	adv					
nine [konuş.]	grandma [coll.]	noun					
Nisan	April <Apr.>	noun					
nişanlı	fiancé	noun					
nişanlı kız	fiancée	noun					
nitelik	quality	noun					
niye	why	adv					
niyet	intent	noun	hiç niyetim yok: I have no intention				
niyet	purpose	noun					
niyet etmek	to contemplate	verb					
niyet etmek	to purpose	verb					
nokta	dot	noun					
nominatif	nominative	noun					
normal	normal	adj					
Norveç	Norway	noun					
not	note	noun					
noter	notary	noun					
nötron yıldızı	neutron star	noun					
Nuh	Noah	noun					
nükleer tıp	nuclear medicine	noun					
numara	number	noun					
o	he	pron					
o	it	pron					
o	she	pron					
o	that	pron					
O iyidir.	He is doing well.	phrase					
O nasıl?	How's he doing?	phrase					
obua	oboe	noun					
öbür gün	the day after tomorrow	adv					
oburluk	gluttony	noun					
ocak	stove	noun					
oda	room	noun					
odaklanmak	to focus	verb					
odaklanmak	to focus on	verb					
ödemek	to pay	verb					
ödev	homework	noun					
ödünç	on loan	adj	ödünç almak: to borrow				
ödünç almak	to borrow	verb					
ödünç vermek	to borrow	verb					
ofis	office	noun					
öfke	anger	noun					
öfke	rage	noun					
öfkeli	angry	adj					
öfkeyle	angrily	adv					
Oğlak Dönencesi	Tropic of Capricorn	noun					
oğlan	boy	noun							
öğle	noon	noun	öğle yemeği: lunch				
öğle yemeği	lunch	noun					
öğleden önce	forenoon	noun					
öğleden sonra	afternoon	noun					
öğleden sonra	in the afternoon	adv					
öğleyin	at midday	adv					
öğrenci	student	noun						
öğrenmek	to find out	verb					
öğrenmek	to elicit	verb					
öğrenmek	to learn	verb					
öğretmek	to teach	verb					
öğretmen	teacher	noun					
öğretmiş	taught	adj					
oğul	son	noun					
öğüt	advice	noun					
Okeanos	Oceanus	noun					
oklokrasi	ochlocracy	noun					
ökse ardıç kuşu [Turdus viscivorus]	mistle thrush	noun					
oksijen	oxygen	noun					
öksürmek	to cough	verb					
öksürük	cough	noun					
öksürük otu [Tussilago farfara]	coltsfoot	noun					
okul	school	noun					
okuma	reading	noun	okumayı bitirince: after having read				
okumak	to read	verb					
okumak	to study	verb					
okyanus	ocean	noun					
olabilir	possible	adj					
olağan	usual	adj					
olağanüstü	superb	adj					
olanaklı	possible	adj					
olanaksız	impossible	adj					
olasılıkla	probably	adv					
olay	incident	noun	olay sırasında: during the incident				
olay	event	noun	olayında: in the case of				
oldu	it happened	phrase	olduğu gibi: as it is	oldu olacak: it's enough to			
oldukça	fairly	adv					
oldukça	quite	adv					
öldürmek	to kill	verb					
öldürücü	pernicious	adj					
oligosakkarit	oligosaccharide	noun					
olmadı	it didn't happen	phrase	olup olmadığı: whether or not				
olmak	to become	verb					
olmak	to be	verb					
olmak	to happen	verb					
olmalıdır	should be	phrase					
ölmek	to die	verb					
olsa bile	even if	adv					
ölü	dead	noun					
ölüm	death	noun					
ölümcül	deadly	adj					
ölümcül	pernicious	adj					
olumlu	positive	adj					
ölümlü	mortal	adj					
olur	okay	noun	olur mu: is it possible				
oluşmak	to consist of	verb					
oluşmak	to become	verb					
oluşturmak	to create	verb					
ömür	lifetime	noun					
omurga	backbone	noun					
omurga	spinal column [Columna vertebralis]	noun					
omuz	shoulder	noun					
omuz silkmek	to shrug	verb					
on	ten	noun					
ön	front	noun					
ön ad	first name	noun					
on altı	sixteen	noun					
on beş	fifteen	noun					
on bir	eleven	noun					
on dokuz	nineteen	noun					
on dört	fourteen	noun					
on iki	twelve	noun					
on sekiz	eighteen	noun					
on üç	thirteen	noun					
on yedi	seventeen	noun					
ona	him [indirect object]	pron					
Ona haber ileteyim mi?	Can I take a message for him / her?	phrase					
önad	adjective	noun					
onay	permit	noun					
önce	ago [postpos.]	adv					
önce	before	conj					
önce gelmek	forego	verb					
önce gitmek	forego	verb					
önceki	former	adj					
önceki	prior	adj					
önceki gün	the day before yesterday	adv					
öncelikli	prior [of high priority]	adj					
öncesinde	before that	adv					
ondan dolayı	thus [therefore]	adv					
Ondan naber?	How's he doing?	phrase					
ondan önce	before that	adv					
önde	ahead	adv					
önemli	important	adj	önemli olan: what matters				
önemli	serious	adj					
Önemli değil!	Never mind!	phrase					
önemsiz	indifferent	adj					
öneri	suggestion	noun					
önerme	proposition	noun					
öngezegen	protoplanet	noun					
onkoloji	oncology	noun					
onlar	they	pron					
onlara	them [direct object]	pron					
önleme	prevention	noun					
onlu yarış	decathlon	noun					
ontolojik	ontological	adj					
onu	him [direct object]	pron					
önümüzdeki	next	adj					
onun	his [possessive]	pron					
onun için	therefore	adv					
önünde	in front of	prep					
önüne	in front of sone	prep					
onunki	hers	pron					
önyıldız	protostar	noun					
öpmek	to kiss	verb					
opsiyonel	optional	adj					
öpücük	kiss	noun					
öpücük [kondurma]	peck	noun					
öpüşmek	to smooch	verb	öpüşüp koklaşmak: to smooch				
orada	over there	adv					
orada	there	adv					
oradan	from there	adv					
Oraya nasıl gidilir?	How do I get there?	phrase					
ördek	duck	noun					
ordu	army	noun					
ordu	military	noun					
Orfe	Orpheus	noun					
organizma	organism [living thing]	noun					
orgazm	orgasm	noun					
örgütü	organization	noun					
orkinos	tuna	noun					
orman	forest	noun					
orman çıvgını [Phylloscopus sibilatrix]	wood warbler	noun					
örneğin	for example <e.g.>	adv					
örneğin	for instance <f.i.>	adv					
örnek	example	noun	örnek olarak: for example				
örneklik	typical	adj					
orta	middle	noun					
orta parmak	middle finger	noun					
ortalama	average	noun					
ortalama çap [vida dişi]	pitch diameter	noun					
ortanca	middle	noun					
ortasından	through	adv					
ortopedi doktoru	orthopaedist [Br.]	noun					
örümcek	spider	noun					
Osmanlı İmparatorluğu	Ottoman Empire	noun					
osteoporoz	osteoporosis	noun					
öte	beyond	adv	öte yandan: on the other hand				
ötede	over there	adv					
otel	hotel	noun					
ot	herb	noun					
ötmek	to sing	verb					
otoban	freeway	noun					
otobüs	bus	noun					
otobüs [uzun seyahat]	coach [esp. Br.]	noun					
otobüs durağı	bus stop	noun					
otobüs sürücüsü	bus driver	noun					
otomobil	car	noun					
otonomi	autonomy	noun					
oturak	seat	noun					
oturan	inhabitant	noun					
oturma odası	living room	noun					
oturmak	to live	verb					
oturmak	to reside	verb					
oturmak	to sit	verb					
otuz	thirty	noun					
oy	vote	noun					
oy vermek	to vote	verb					
öyle	like that	adv	öyle de oldu: so it did				
öyle	such	adj					
öyle	so	adv					
öyle	such	adv					
oynamak	to play	verb					
oynatmak	to move	verb					
oyuk	hollow	adj					
oyun	game	noun					
oyunca	toy	noun					
oyuncak	toy	noun					
oyuncu	actor	noun					
oyuncu	player	noun					
oyuncu [kadın]	actress	noun					
öz	genuine	adj					
özel	special	adj					
özel	private	adj					
özellikle	above all	adv					
özellikle	especially <esp.>	adv					
özellikle	particularly	adv					
özet	summary	noun					
özgür	free	adj					
özgürlük	freedom	noun					
özlem	hunger [longing]	noun					
özlem duymak	to long for	verb					
özlem duymak	to miss	verb					
özlemek	to miss	verb					
özne	subject	noun					
özsu	juice	noun					
özür	apology	noun					
özür	excuse	noun					
özür dileme	apology	noun					
özür dilemek	to apologise [Br.]	verb					
özür dilemek	to apologize	verb					
özür dilemek	to excuse	verb					
Özür dilerim!	Excuse me!	phrase					
Özür dilerim, [dediğinizi] anlamadım.	I'm sorry, I didn't get / catch that.	phrase					
Özür dilerim.	I am sorry.	phrase					
Özür!	Sorry!	phrase					
pabuç	shoe	noun					
pabuç	slipper	noun					
paha	price	noun					
pahalı	expensive	adj					
pak	clean	adj					
paleoklimatoloji	palaeoclimatology [Br.]	noun					
paleoklimatoloji	paleoclimatology [Am.]	noun					
palto	coat	noun					
pamuk	cotton	noun	pamuk şeker: cotton candy				
pamuk	cotton wool	noun					
pamuk balığı [Prionace glauca]	blue shark	noun					
panteizm	pantheism	noun					
Pantekost	Pentecost	noun					
Pantekot	Pentecost	noun					
Pantkot	Pentecost	noun					
papağan	parrot	noun					
para	money	noun					
para basmak	monetize	verb					
para birimi	currency	noun					
para çekmek	to withdraw money	verb					
para çıkarmak	monetize	verb					
paralel	parallel	adj					
paranoya	paranoia	noun					
paranoyak	paranoid	adj					
paranoyak	paranoidal	adj					
parapsikoloji	parapsychology	noun					
parasal	financial	adj					
parasızlık	impecuniosity	noun					
parça	piece	noun					
parça	component	noun					
parça	fragment	noun					
parça	morsel	noun					
parça	part	noun					
parça	portion	noun					
parçacık fiziği	particle physics [treated as sg.]	noun					
parçacık hızlandırıcı	particle accelerator	noun					
Pardon!	Excuse me!	phrase					
Pardon!	Sorry!	phrase					
parfüm	perfume	noun					
parfüm sürmek	to perfume	verb					
parıldamak	to glint	verb					
park	park	noun					
parke	floorboard	noun					
parlak	brilliant	adj					
parlamak	to shine	verb					
parmak	finger	noun					
parmak	digit [finger]	noun					
parmak	finger	noun					
parmak	finger [Digitus manus]	noun					
parmak tırnağı	fingernail	noun					
parmaklar {pl}	fingers [Digiti manus]	noun					
pars [Panthera pardus]	leopard	noun					
pasaport	passport	noun					
pasbaş patka [Aythya nyroca]	ferruginous duck	noun					
pasbaş patka [Aythya nyroca]	ferruginous pochard	noun					
pasifizm	pacifism	noun					
Paskalya	Easter	noun					
pasta	cake	noun					
pasta	tart	noun					
patates	potatoes	noun					
patates	potato	noun					
patates kızartması	chips [Br.]	noun					
patates kızartması	French fries [Am.]	noun					
patates kızartması	fried potatoes	noun					
patates kızartması	roast potato	noun					
patinaj	ice skating	noun					
patırtı	noise	noun					
patlak vermek	to break out	verb					
patlama	explosion	noun					
patlama	bang	noun					
patlıcan [Solanum melongena]	aubergine [esp. Br.]	noun					
paylaşmak	to share	verb					
pazar	market	noun					
pazar	Sunday <Sun., Su.>	noun					
pazarlık etmek	to bargain	verb					
pazartesi	Monday <Mon., Mo.>	noun					
peçete	napkin	noun					
pedofili	paedophilia [Br.]	noun					
pedofili	pedophilia [Am.]	noun					
pek	very	adv					
pek çabuk	rapid	adj					
pek çok	very	adv					
peluş	plush	adj					
pembe	rosy	adj					
pembe	pink	adj					
pencere	window	noun					
pencere eşiği	windowsill	noun					
penguen	penguin	noun					
Pensilvanya	Pennsylvania	noun					
Pentekost	Pentecost	noun					
perde	curtain	noun					
Perde Açılıyor	All About Eve [Joseph L. Mankiewicz]	phrase					
peri	fairy	adj					
perişan	distraught	adj					
pernisiyöz	pernicious	adj					
perşembe	Thursday <Thu., Th.>	noun					
pervane	propeller	noun					
pes etmek	to give up [surrender, relinquish]	verb					
Petri kabı	Petri dish	noun					
peynir	cheese	noun					
pezevenk	pimp	noun					
pijama {sg}	pajamas {pl} [Am.]	noun					
piknik	picnic	noun					
pil	battery	noun					
pilav [yemek]	rice [meal]	noun					
pilot	pilot	noun					
pire	flea	noun					
pirinç	brass	noun					
pirinç	rice	noun					
piromani	pyromania	noun					
pirsing	piercing	noun					
pirzola	chop	noun					
pis	dirty	adj					
pişirmek	to cook	verb					
pişmek	to cook	verb					
pıtırtı	patter	noun					
piyasaya para sürmek	monetize	verb					
pizza	pizza	noun					
plaj	beach	noun					
plan	plan	noun					
planlamak	to plan	verb					
polder	polder	noun					
polinom	polynomial	noun					
polis [konuş.]	policeman	noun					
polis {sg}	police {pl}	noun					
polisakkarit	polysaccharide	noun					
politoloji	political science	noun					
politoloji	politology	noun					
Polonya	Poland	noun					
pornografi	pornography	noun					
porselen	china	noun					
porselen	porcelain	noun					
portakal	orange	noun					
portakal rengi	orange	adj					
portakal suyu	orange juice	noun					
Portekiz	Portugal <.pt>	noun					
Portekizli	Portuguese	adj					
posta kartı	postcard	noun					
posta kartları	postcards	noun					
postahane	post office <PO>	noun					
postane	post office <PO>	noun					
potasyum	potassium	noun					
potasyum dikromat [K2Cr2O7]	potassium dichromate	noun					
potasyum iyodat [KIO3]	potassium iodate	noun					
potasyum klorat [KClO3]	potassium chlorate	noun					
poyraz	northeaster	noun					
Prag Baharı	Prague Spring	noun					
pratik	convenient	adj					
pratik	handy	adj					
pratisyen doktor	practitioner	noun					
prens	prince	noun					
prenses	princess	noun					
primatoloji	primatology	noun					
priz	outlet	noun					
priz	socket	noun					
problem	trouble	noun					
Prometheus	Prometheus	noun					
protein	protein	noun					
pudra	powder	noun					
Puglia	Apulia	noun					
pul	stamp	noun					
püre	puree	noun					
pürüzsüzce	fluently [of movement]	adv					
püsküllü	fringed	adj					
Putinizm	Putinism	noun					
radyo	radio	noun					
radyo astronomi	radio astronomy	noun					
radyoliz	radiolysis	noun					
radyoterapi	radiotherapy	noun					
raf	shelf	noun					
rafine etmek	to refine	verb					
rağmen	in spite of	prep					
rahat	comfortable	adj					
rahat	convenient	adj					
rahat	easy	adj					
rahatlık	convenience	noun					
rahatsız etmek	to disturb	verb					
rahatsızlık	disease	noun					
rahmetlik	deceased	adj					
rakam	digit	noun					
rakam	figure	noun					
Ramazan	Ramadan	noun					
randevu	appointment	noun					
ranza	bunk	noun					
rastlantı	coincidence	noun					
ray	railroad <RR> [Am.]	noun					
rayba	reamer	noun					
raybalamak	to ream	verb					
razı etmek	to persuade	verb					
reçel	jam	noun					
reçete	prescription	noun					
reçetesi	prescription	noun					
reddetmek	to reject	verb					
reddetmek	to refuse	verb					
reddetmek	to reject	verb					
redüksiyonizm	reductionism	noun					
reflektör	reflector	noun					
renk	colour	noun					
renk	colour [Br.]	noun					
resim	picture	noun					
restoran	restaurant	noun					
rezene	fennel [Foeniculum vulgare]	noun					
ribonükleik asit <RNA>	ribonucleic acid <RNA>	noun					
Rica ederim!	Please!	phrase					
rica etmek	to ask for	verb					
rica etmek	to ask	verb					
Richard incir kuşu [Anthus richardi]	Richard's pipit	noun					
rinoplasti	rhinoplasty	noun					
riskli	dangerous	adj					
Roma Tatili	Roman Holiday [William Wyler]	phrase					
rötar	delay	noun					
rötüş	retouching	noun					
ruh	soul	noun	ruh eş: soul mate				
ruhsat	certificate	noun					
ruhsat	permit	noun					
Rusça	Russian	noun					
Rusya	Russia <.ru>	noun					
rüya	dream	noun					
rüya görmek	to dream	verb					
rüzgar	wind	noun					
rüzgarlı	windy	adj					
saat	watch	noun	saat kaç? what time is it?				
saat	clock	noun					
saat	hour <h, hr>	noun					
saat	time of day	noun					
Saat kaç?	What time is it?	phrase					
saat yönünde	clockwise	phrase					
sabah	early	adv					
sabah	morning	noun					
sabahleyin	early	adj					
sabahleyin	in the morning	adv					
sabır	patience	noun					
sabırlı	patient	adj					
sabırsız	impatient	adj					
sabırsızlanmak	to look forward to	verb					
sabit	still	adj					
sabit eşya	fixtures {pl}	noun					
sabitlemek	to fix [fasten]	verb					
sabun	soap	noun	sabun köpüğü: soap bubble				
saç	hair	noun					
saç fırçası	hairbrush	noun					
saç kurutma makinesi	hair dryer	noun					
saç tokası	hairpin	noun					
saçaklı	fringed	adj					
saçmalamak	to talk nonsense	verb					
saçmalık	nonsense	noun					
Saçmalık!	Rubbish! [esp. Br.]	phrase					
sade	plain	adj					
sadece	only	adv					
saf	naive	adj					
saf olmama	impurity	noun					
şafak	dawn	noun					
sağ tarafta	on the right-hand side	adv					
sağa	to the right	adv					
sağa doğru	to / on the right	adv					
sağa dönmek	to turn right	verb					
sağda	on the right-hand side	adv					
sağda	to / on the right	adv					
sağlam	healthy	adj					
sağlamlaştırmak	to fortify	verb					
sağlık	health	noun	sağlık açısından: for the health				
sağlıklı	healthy	adj					
Sağol!	Thank you!	phrase					
Sağolun!	Thank you!	phrase					
saha	field	noun					
sahanda yumurta	fried egg	noun					
sahanda yumurta	scrambled eggs {pl}	noun					
şahane	magnificent	adj					
sahi	really	adv					
sahibi	owner	noun					
sahiden	really	adv					
sahiden	actually	adv					
sahiden	to be honest	adv					
sahil	coast	noun					
sahil	shore	noun					
Sahilde Kafka [Haruki Murakami]	Kafka on the Shore	phrase					
sahip	owner	noun					
sahip olmak	to have got	verb					
sahip olmak	to have	verb					
sahip olmak	to own	verb					
şahıs	person	noun					
şahitlik	testimony	noun	şahitlik etmek: to witness				
sahne	scene	noun					
sahne	stage	noun					
şahsi	self	pron					
şaka	joke	noun					
şaka mı yapıyorsun?	Are you kidding?	phrase					
şaka yapıyorum.	I'm just kidding.	phrase					
şakacı	playful	adj					
sakal	beard	noun					
sakat	disabled	adj					
sakatlamak	to injure	verb					
sakatlar {pl}	disabled people {pl}	noun					
sakin	calm	adj	sakin ol: calm down				
sakin	quiet	adj					
sakınmak	to avoid	verb					
sakkaroz	saccharose	noun					
saklamak	to hide	verb					
saklamak	to keep	verb					
saklanmak	to hide oneself	verb					
saklı	secret	adj					
saksafon	saxophone	noun					
salak	idiot	adj					
salak	stupid	adj					
salak	idiotic	adj					
salak	stupid	adj					
salata	salad	noun					
saldırgan	aggressive	adj					
saldırı	attack	noun					
salı <sal., sa., s.>	Tuesday <Tue., Tu.>	noun					
sallamak	to shake	verb					
salmak	to release	verb					
salmonelloz	salmonellosis	noun					
şalter	switch	noun					
saman	hay	noun					
şamaroğlanı	stooge	noun					
samimi	sincere	adj					
samimiyet	intimacy	noun					
şampuan	shampoo	noun					
Sana da.	The same to you.	phrase					
sanat	art	noun	sanat eseri: artwork				
sanatçı	artist	noun					
sandal	boat	noun					
sandalye	chair	noun					
sandviç	sandwich	noun					
sanı	thought	noun					
saniye	second	noun					
sanki	as if	conj					
sanki	so to speak	adv					
sanmak	to think	verb					
Sanmıyorum.	I don't think so.	phrase					
şans	fortune	noun					
şansın açık olsun!	Good luck!	phrase					
şapka	hat	noun					
saplı küçük tencere	saucepan	noun					
sapma	deviation	noun					
şapşal	silly	adj					
şarap	wine	noun					
saray	castle	noun					
saray	palace	noun					
Sargasso Denizi	Sargasso Sea	noun					
sarhoş	drunk	adj					
sarı	yellow	adj					
sarı centiyan [Gentiana lutea]	(great) yellow gentian	noun					
sarı kiraz kuşu [Emberiza citrinella]	yellowhammer	noun					
sarılmak	to hug	verb					
sarımsak	garlic [Allium sativum]	noun					
sarımsak presi	garlic press	noun						
sarıp sarmalamak	wind up	verb					
sarışın	blonde	adj					
şarkı	song	noun					
şarkı söylemek	to sing	verb					
sarkoidoz	sarcoidosis	noun					
sarmak	to wrap	verb					
sarmak	wind up	verb					
sarmısak	garlic [Allium sativum]	noun					
sarsılmış	shocked	adj					
şart	condition	noun	bir şartla: on one condition				
şasi	chassis	noun					
şaşırmak	to be surprised	verb					
şaşırmış	surprised	adj					
şaşırtmak	to surprise	verb					
satın almak	to buy	verb					
satın almak	to purchase	verb					
satış	sale	noun					
satmak	to sell	verb					
savan	savannah	noun					
savan	savanna	noun					
savaş	war	noun	savaş suçu: war crime				
savaş çığırtkanı	warmonger	noun					
savaş kışkırtıcısı	warmonger	noun					
savaş satıcısı	warmonger	noun					
savaşçı	warrior	noun					
savaşmak	to fight	verb					
savcı	prosecutor	noun					
savunma	defence	noun					
savurmak	to hurl	verb					
sayfa	page	noun					
sayfa	page <p.>	noun					
sayı	number	noun					
sayı	digit	noun					
sayı	figure	noun					
sayı	number	noun					
sayılmak	to be counted	verb					
saymak	to count	verb					
sebebiyle	because of	prep					
sebep	reason	noun					
sebze	vegetable	noun					
sebzelerden yaşayan	vegetarian	adj					
seçebilirmek	to be able to make out	verb					
seçenek	option	noun					
seçilebilir	selectable	adj					
seçim	choice	noun					
seçmek	to choose	verb					
seçmek	to distinguish	verb					
seçmek	to choose	verb					
seçmek	to elect	verb					
seçmek	to select	verb					
sedimantoloji	sedimentology	noun					
sedir	cedar	noun					
sefer	expedition	noun					
şefkat	affection	noun					
şeftali	peach	noun					
şehir	town	noun					
şeker	candy	noun					
şeker	sugar	noun					
şeker	sweet [Br.]	noun					
şekerli	sweet	adj	şekerli bir tat: a sweet taste				
şekil	shape	noun	basit bir şekilde: in a simple way				
sekiz	eight	noun					
sekiz buçukta	at half past eight	phrase					
sekiz yüz	eight hundred	noun					
seksen	eighty	noun					
şelale	waterfall	noun					
sembol	symbol	noun					
Semele	Semele	noun					
şemsiye	umbrella	noun					
sen	you [informal]	pron					
Sen ne düşünüyorsun?	What do you think?	phrase					
sendrom	syndrome	noun					
sene	year	noun					
senkretizm	syncretism	noun					
şenlik	celebration	noun					
sepet	cart	noun					
sepet	basket	noun					
sepet	box	noun					
serbest	free	adj					
şeref	honor	noun					
şerefe!	Cheers!	phrase					
şerefsiz	dishonest	adj					
sergilemek	to perform	verb					
serin	cool	adj					
sermek	to spread	verb					
serpilmek	to sprinkle	verb					
sersem	silly	adj					
sert	hard	adj					
ses	voice	noun					
ses	noise	noun					
ses	sound	noun					
ses	voice	noun					
seslenmek	to call out	verb					
seslenmek	to call	verb					
seslenmek	to shout	verb					
sesli	loud	adj					
sessiz	hushed	adj					
sessiz	quiet	adj					
sessiz	silent	adj					
set	wall	noun					
sevda	love	noun					
sevilen	welcome	adj					
sevimli	amiable	adj					
sevimli	pretty	adj					
sevinç	joy	noun					
sevinçli	glad	adj					
sevişmek	to make love	verb					
seviye	station [in society]	noun					
şevkli	eager	adj					
sevmek	to love	verb					
şey	thing	noun	bir şey: something				
şey	item	noun					
şey	thing	noun					
seyahat	trip	noun					
şeytan	devil	noun					
şeytani	demonic	adj					
sezgi	intuition	noun					
sezmek	to feel	verb					
sezmek	to guess	verb					
Sibirya kazı [Branta ruficollis]	red-breasted goose	noun					
sıcak	hot	adj					
sıcak	warm	adj					
sıcak çikolata	hot chocolate	noun					
sıcaklık	heat	noun					
sıcaklık	temperature	noun					
sıçmak	to shit [be stricken with fear]	verb					
sıçmak	to shit [vulg.] [excrete something from the anus]	verb					
şiddet	violence	noun					
şiddetle	violently	adv					
şiddetli	violently	adv					
sideroz	siderosis	noun					
sıfat	adjective	noun					
şifonyer	chest of drawers	noun					
şifonyer	dresser [Am.] [chest of drawers]	noun					
sığ	shallow	adj					
sigara	cigarette	noun					
sigara içmek	to smoke	verb					
sigara kullanmak	to smoke	verb					
siğilli kurbağa [Bufo bufo]	common toad	noun					
sığır	cattle	noun					
sığır balıkçılı [Bubulcus ibis]	cattle egret	noun					
sığır eti	beef	noun					
sigorta etmek	to insure	verb					
sıhhiyeci	paramedic	noun					
şık	dapper	adj					
şık	fashionable	adj					
sık sık	often	adv					
sık sık olan	frequent	adj					
şikayet	complaint	noun	şikayet etmek: to complain				
şikâyet	complaint	noun					
sıkça	frequently	adv					
sıkı	tight	adj					
sıkıcı	boring	adj					
sıkılmış	bored	adj					
sıkıntı	trouble	noun					
sıkıştırılmış hava	compressed air	noun					
sikke	coin	noun					
sıkmak	to squeeze	verb					
Siktir git!	Fuck off! [vulg.]	phrase					
silah	weapon	noun					
şili	Chile	noun					
silmek	to delete	verb	sil almak: to get a delete				
silmek	to clean	verb					
şimdi	now	adv	asıl şimdi: right now	şimdiden: already			
şimdi	just	adv					
şimdi	now	adv					
şimdiden	already	adv					
şimdiki	current	adj					
şimdiki zaman	present	noun					
şimdiye kadar	so far	adv					
simge	sign	noun					
simpatrik türleşme	sympatric speciation	noun					
şimşek	lightning	noun					
şimşek	thunderbolt	noun					
sımsıcak	very hot	adj					
sımsık	tight	adj					
sımsıkı	firmly	adv					
simsiyah	black as coal	adj					
simsiyah	ebony [color]	adj					
simsiyah	jet black	adj					
simsiyah	raven [color]	adj					
sincap	squirrel	noun					
sinema	cinema [Br.]	noun					
sınıf	class	noun					
sınıflandırmak	subsume	verb					
sinir	nerve [Nervus]	noun					
sınır	border	noun					
sınır	edge	noun					
sinir sistemi	nervous system	noun					
sinirli	angry	adj					
sinirli	nervous	adj					
sınırlı	limited	adj					
şinitsel	cutlet	noun					
şinitsel	escalope	noun					
sinsi	sly	adj					
sinsice	furtive	adj					
sipariş	order	noun					
sıparış	order	noun					
sipariş etmek	to order	verb					
sıra	order	noun					
sıra	sequence	noun	arasıra: occasionally	sıradan: ordinary	sıralarında: around		
Sıra bende.	It's my turn.	phrase					
Sıra sende.	It's your turn.	phrase					
sıradan	ordinary	adj					
sıralarında	around	adv					
sırasında	at	prep					
sırf	merely	adv					
sırf	sheer	adj					
sırf	only	adv					
şirin	pleasant	adj					
şirin	pretty	adj					
sirke	vinegar	noun					
şirketi	company	noun					
sırt	back	noun					
sırt çantası	backpack	noun					
sırt çantası	rucksack	noun					
şişe	bottle	noun					
şişkinlik	swelling	noun					
sisli	foggy	adj					
şişman	obese	adj					
şişmek	to swell	verb					
sıvı yağ	oil	noun					
sivri	sharp	adj					
siyah	black	adj					
siyaset	politics	noun					
sıyırmak	to scrape	verb					
Siyonizm	Zionism	noun					
sıyrılmak	to elude	verb					
siz	you {pl}	pron					
sizi	you [plural direct and indirect object] [informal]	pron					
Sizin ... var mı?	Do you have ... ?	phrase					
Sizin fikriniz nedir?	What is your opinion?	phrase					
Sizin için ne yapabilirim?	What can I do for you?	phrase					
sızıntı	leak	noun					
sızlamak	to ache	verb					
sızlamak	to burn	verb					
sizlerle	with you	pron					
sızmak	to infiltrate	verb					
şnorkelle yüzmek	to snorkel	verb					
soba	stove	noun					
sodyum borhidrür [NaBH4]	sodium borohydride	noun					
sodyum bromür [NaBr]	sodium bromide	noun					
şoför	chauffeur	noun					
şoför	driver	noun					
sofra	table	noun					
sofra takımı	cutlery	noun					
soğan	onion	noun					
soğanlar {pl}	onions	noun					
soğuk	cold	adj					
söğüt	willow	noun					
söğütbülbülü [Phylloscopus trochilus]	willow warbler	noun					
soğutmak	to cool down	verb					
sohbet etmek	to chat	verb					
sokmak	to tuck	verb					
sol tarafa	to the left	adv					
sola	left	adj					
sola	to the left	adv					
sola doğru	to the left	adv					
solak	left-hander	noun					
solda	to / on the left	adv					
solenoid	solenoid	noun					
solgunluk	pallor	noun	solgunluk veren: pallid				
solunum	breathing	noun					
som balığı	salmon	noun					
somun	nut	noun					
somun [ekmek, odun]	loaf [bread, wood]	noun					
somurtmak	to sulk	verb					
somutlaştırmak	to reify	verb					
son	last	adj	sonra devam ediyoruz: then we continue	sonraki: next	sonsuz: forever		
son	end	noun	sonuna kadar: till the end				
son	conclusion	noun					
son	end	noun					
son	last	adv					
son vermek	wind up	verb					
sonbahar	autumn	noun					
sonbahar	fall [Am.]	noun					
sönmek	to go out [light, fire]	verb					
sonra	after	adv					
sonra	afterwards	adv					
sonra	next	adv					
sonraki	next	adj					
sonraya bırakmak	to postpone	verb					
sonsuz	forever	adj					
sonsuzluk	eternity	noun					
sonuç	result	noun	sonucu olmak: to result	sonuçlanmak: to conclude			
sonuçlanmak	to conclude	verb					
sonuncu	last	adj					
sonunda	eventually	adv					
sorgu	interrogation	noun					
sorguya çekmek	to examine	verb					
sormak	to ask	verb					
şort	shorts	noun					
soru	question	noun					
sorum	responsibility	noun					
sorumluluk	responsibility	noun					
sorun	trouble	noun					
Sorun değil!	No problem! <np>	phrase					
soruşturma	investigation	noun					
sos tavası	saucepan	noun					
sosis	sausage	noun					
sosyoloji	sociology	noun					
şövalye	knight [Middle Ages warrior]	noun					
soyad	surname	noun					
soykırım	genocide	noun					
söylemek	to speak	verb	şöyle söyleyeyim: let me tell you				
söylemek	to sing	verb					
söylemek	to pronounce	verb					
söylemek	to say	verb					
söylemek	to speak	verb					
söylemek	to talk	verb					
söylenilen	said	adj					
söyleniş	pronunciation	noun					
söyleyip yazdırmak	to dictate	verb					
söz	promise	noun	sözüm ona denirse: so to speak				
söz vermek	to promise	verb					
sözcük	word	noun					
sözlük	dictionary	noun					
spagetti	spaghetti	noun					
stereokimya	stereochemistry	noun					
streptomisin [C21H39N7O12]	streptomycin	noun					
su	juice	noun					
su	water	noun					
su [normal, gazsız]	still water	noun					
şu an	present	noun					
şu anda	now	adv					
su kılavuzu [Rallus aquaticus]	water rail	noun					
suale	to the question	phrase	suale karşı: to the question				
suaygırı	hippopotamus	noun					
subaşı	officer	noun					
şubat <şub.>	February <Feb.>	noun					
sübvansiyon	subsidy	noun					
suç	crime	noun					
suç	fault	noun					
suçlamak	to blame	verb					
sucuk	sujuk	noun					
suikastçı	assassin	noun					
şükretmek	to thank	verb					
sulu	juicy	adj					
sulugözlü	lachrymose	adj					
sümkürmek	to blow one's nose	verb					
sünger	sponge	noun					
sunmak	to introduce	verb					
süperenfeksiyon	superinfection	noun					
süpermarket	supermarket	noun					
şüphe	doubt	noun					
şüphelenmek	to doubt	verb					
şüpheli	suspect	noun					
şüphesi olmak	to doubt	verb					
şüphesiz	certainly	adv					
şüphesiz ki	indeed	adv					
süprematizm	Suprematism [also: suprematism]	noun					
süpürge	broom	noun					
surat	face	noun					
süre	time	noun					
süre	duration	noun					
süreç	process	noun					
süresince	through	adv										
sürgü	lock [latch, bolt]	noun					
sürmek	to spread	verb					
sürmek	to continue	verb					
sürmek	to drive	verb					
sürmek	to last	verb					
sürmek	to plow	verb					
sürmek	to take [to last]	verb					
sürmeli çalı kuşu [Regulus ignicapill, syn.: Regulus ignicapillus]	(common) firecrest	noun					
sürpriz	surprise	noun					
sürpriz yapmak	to surprise	verb					
sürtmek	to rub	verb					
sürü	crowd	noun	bir sürü: a lot of				
sürü	herd	noun					
sürücü	driver	noun					
sürükleme	drag	noun					
susak	thirsty	adj					
susamak	to be thirsty	verb					
susamış	thirsty	adj					
susuz	thirsty	adj					
süt	milk	noun	etliye sütlüye karışmamak: not interested in anything				
şuur	consciousness	noun					
süveter	sweater	noun					
süzmek	to contemplate	verb					
süzmek	to filter	verb					
süzülmek	to float	verb					
ta ötede	over there	adv					
taba rengi	tan	adj					
tabak	plate	noun					
taban	sole	noun					
tabanca	gun	noun					
tabii	of course	adv					
tabip	doctor	noun					
tabure	stool	noun					
taciz	abuse	noun	taciz etmek: to abuse				
tad	taste	noun	tadını çıkarmak: to enjoy				
tadına bakmak	to taste	verb					
tadını çıkarmak	to enjoy	verb					
tahıl	grain	noun					
tahmin	guess	noun	tahmin etmek: to suppose				
tahmin edilmiş	estimated <est.>	phrase					
tahmini	about [approximate]	adv					
tahmini	estimated <est.>	adj					
tahrik etmek	to goad	verb					
tahrik etmek	wind up	verb					
tahrip etmek	to damage	verb					
tahriş	irritation	noun					
tahta	board	noun					
tahta	wood	noun					
tahterevalli	seesaw	noun					
takarmak	to wear	verb					
takdir	regard	noun					
takdirde	in case	conj					
takım elbise	suit	noun					
takımada	archipelago	noun					
takip etmek	to chase	verb					
takip etmek	to follow	verb					
takırdamak	to rattle	verb					
takke	cap	noun					
taksi	cab	noun					
taksi	taxi	noun					
talan	pillage	noun	talan etmek: to plunder				
talep etmek	to claim	verb					
talep etmek	to require	verb					
talih	fortune	noun					
talimat	instruction	noun					
tam	exactly	adv					
tam	whole	adj					
tam aksine	the other way round [Br.]	adv					
tam tersine	the other way round [Br.]	adv					
tamam	all right	adv					
tamamen	completely	phrase					
tamamlamak	to accomplish	verb					
tamir	mending	noun					
tamir etmek	to repair	verb					
tamir etmek	to mend	verb					
tamirhane	garage	noun					
tamirhane	workshop	noun					
tampon	bumper	noun					
tane	grain	noun					
tane [bitki]	grain	noun					
tanımak	to recognize	verb					
Tanıştığımıza memnun oldum.	Nice to meet you.	phrase					
Tanıştırabilir miyim, ...	May I introduce ...	phrase					
tanıtmak	to introduce	verb					
tanrılaştırmak	to adore	verb					
tantana	fanfare	noun					
taoizm	Daoism	noun					
taoizm	Taoism	noun					
Tapınak şövalyeleri {pl}	Knights Templar	noun					
tapmak	to adore	verb					
taptaze	fresh	adj					
taraf	side	noun	arka tarafta: at the back				
tarak	comb	noun					
tarakdiş [Mergus serrator]	red-breasted merganser	noun					
taramak	to scan	verb					
taramalı tünelleme mikroskobu	scanning tunnelling microscope <STM> [Br.]	noun					
tarçın	cinnamon [Cinnamomum zeylanicum]	noun					
tarife	schedule	noun					
tarife	timetable	noun					
tarih	date	noun	kullanma tarihi: expiry date				
tarih	history	noun					
tarihi	historical	adj					
tarla	field	noun					
tarla çintesi [Emberiza calandra, syn.: Miliaria calandra]	corn bunting	noun					
tarla kazı [Anser fabalis]	bean goose	noun					
tarla kiraz kuşu [Emberiza calandra, syn.: Miliaria calandra]	corn bunting	noun					
tartı	bathroom scales	noun					
tartışma	argument	noun					
tartışma	quarrel	noun					
tartışmak	to argue	verb					
tartışmak	to quarrel	verb					
tas	bowl	noun					
taş	stone	noun	taş devri: stone age				
taş	rock	noun					
taş	stone	noun					
tasarlamak	to intend	verb					
tasarruf etmek	to save	verb					
tasfiye etmek	wind up	verb					
taşımak	to carry	verb					
taşınma	move	noun					
taşınmak	to move in	verb					
taşınmak	to move sg	verb					
tasvir etmek	to describe	verb					
tat	taste	noun					
Tatar	Tatar	noun					
tatil	holiday	noun	tatile çıkmak: to go on holiday				
tatil yapmak	to go on holiday	verb					
tatile çıkmak	to go on holiday	verb					
tatlı	sweetie	noun					
tatlı	sweet	adj					
tatlı	candy	noun					
tatlı	dessert	noun					
tatlı	sweet	noun					
tatmak	to taste	verb					
tatmin etmek	to satisfy	verb					
tatmin olmuş	satisfied	adj					
tava	pan	noun					
tavan	ceiling	noun					
tavlamak	to pick up	verb					
tavşan	hare	noun					
tavşanı	bunny	noun					
tavsiye	recommendation	noun	tavsiye etmek: to recommend				
tavuk	chicken	noun					
tay	colt	noun					
taze	fresh	adj					
tebessüm	smile	noun					
tecil	postponement	noun					
tecrübe	experience	noun					
tedavi	treatment	noun	tedavi etmek: to cure				
tedbirli	careful	adj					
tedbirsiz	careless	adj					
tedirgin	anxious	adj	tedirgin etmek: to trouble				
tehdit	threat	noun					
tehir	delay	noun					
tehlike	danger	noun					
tehlikeli	dangerous	adj					
tehlikeli	pernicious	adj					
tek	lonely	adj					
tekel	monopoly	noun					
teker	wheel	noun					
tekerlek	tire [Am.]	noun					
tekerlek	wheel	noun					
tekerlek lastiği	tyre [Br.]	noun					
teklif	offer	noun					
tekme	kick	noun					
teknik	technique	noun	teknik olarak: technically				
tekrar	again	adv					
tekrar olmak	to recur	verb					
tekrarlamak	to repeat	verb					
Teksas	Texas	noun					
telaffuz	pronunciation	noun					
telaffuz etmek	to pronounce	verb					
telaş	trepidation [worry]	noun					
telaş	worry	noun					
telaşlı	fussing	adj					
telefon	phone	noun					
telefon etmek	to call [telephone]	verb					
telefon numarası	phone number	noun					
televizyon	television	noun					
televizyon izlemek	to watch television	verb					
telkuyruk [Clangula hyemalis]	long-tailed duck	noun					
telve	coffee grounds	noun	kahve telvesi: coffee grounds				
tembel	lazy	adj					
temel	basic	adj					
temettüler [eski]	profit distribution	noun					
temiz	clean	adj	temiz hava: fresh air				
temizlemek	to clean	verb					
Temmuz	July	noun					
temsil	show	noun					
tencere	pot	noun					
teneffüs [okulda]	break	noun					
teneke	tin	noun					
teneke kaplamak	to tin	verb					
tenha	deserted	adj					
teorik kimya	theoretical chemistry	noun					
teozofi	theosophy	noun					
tepe	hill	noun					
tepe açısı [vida]	thread angle	noun					
tepeli baştankara [Lophophanes cristatus, syn.: Parus cristatus]	(European) crested tit	noun					
tepeli guguk [Clamator glandarius]	great spotted cuckoo	noun					
tepeli patka [Aythya fuligula]	tufted duck	noun					
tepeli pelikan [Pelecanus crispus]	Dalmatian pelican	noun					
tepeli toygar [Galerida cristata]	crested lark	noun					
tepki	reaction	noun					
tercih	preference	noun					
tercihler {pl}	preferences	noun					
tercüman	translator	noun					
tereddüt etmek	to hesitate	verb					
tereddütlü	hesitant	adj					
tereyağı	butter	noun					
terk etmek	to go [to leave]	verb					
terk etmek	to leave	verb					
terlemek	to sweat	verb					
terliksi	paramecium	noun					
terzi	tailor	noun					
tesadüfen	by chance	adv					
teşebbüs [osm.]	attempt	noun					
teşekkür borçlu	thankful	adj					
teşekkür etmek	to thank	verb					
Teşekkürler!	Thanks!	phrase					
Teşekkürler!	Thank you!	phrase					
tesettürlü	hijab	noun					
teşhircilik	exhibitionism	noun					
teslim olmak	to give up [surrender, relinquish]	verb					
tespit	detection	noun	iyi tespit: well spotted	tespit etmek: to determine			
testere	saw	noun					
testi	jug	noun					
teyze	aunt [mother's sister]	noun					
tez	thesis	noun					
tezene	plectrum	noun					
theofani	theophany	noun					
ticaret yapmak	to deal	verb					
ticari	business	noun					
tıkamak	to stuff	verb					
tıkanık	congested	adj					
tiksindirici	repulsive	adj					
tiksinti	disgust	noun					
tilki	fox	noun					
timokrasi	timocracy	noun					
timsah	crocodile	noun					
timsah kapan kaplumbağası [Macrochelys temminckii]	alligator snapping turtle	noun					
tıngırdamak	to rattle	verb					
tip	type	noun					
tipik	typical	adj					
tırabzan	handrail	noun					
tıraş	shave	noun					
tırmanmak	to climb	verb					
tırnak	nail	noun					
tırtıl	caterpillar [insect]	noun					
tişört	T-shirt	noun					
titremek	to tremble	verb					
titremek	to shiver	verb					
titremek	to shake	verb					
titreşmek	to shake	verb					
tok	full (up)	adj					
tok	full	adj					
tombul	chubby	adj					
tomografi	tomography	noun					
tomurcuk	bud	noun					
tonbalığı	tuna	noun					
top	ball	noun					
toplam	total	adj					
toplama	addition	noun					
toplamak	to collect	verb					
toplamak	to tidy up	verb					
toplanan	addend	noun					
toplantı	meeting	noun					
topluluk	community	noun					
toplum	commmunity	noun					
topuk	heel	noun					
torna	lathe	noun					
tornavida	screwdriver	noun					
Toros göknarı [Abies cilicica]	Cilician fir	noun					
torun	grandchild	noun					
torun [erkek]	grandson	noun					
tost	toast	noun					
toy	immature	adj					
toy [Otis tarda]	great bustard	noun					
toynak	hoof	noun					
toz	dust	noun					
trabzan	banister	noun					
trafik	traffic	noun					
trafik ışığı	traffic lights {pl.}	noun					
trafik lambası	traffic lights	noun					
trafik levhası	traffic sign	noun					
trans kadın	trans woman [male-to-female transsexual]	noun					
tren	train	noun					
tren istasyonu	train station	noun					
tren yolu	railroad <RR> [Am.]	noun					
trombosit	(blood) platelet	noun					
trombosit	thrombocyte	noun					
trompet	trumpet	noun					
tsunami	tsunami	noun					
tüccar	merchant	noun					
tuhaf	strange	adj					
tuhaf	odd	adj					
tuhaf	strange	adj					
tüketen	consuming	adj					
tüketmek	to consume	verb					
tüm	all	adj	tüm gücümle: with all my strength				
tüm	entire	noun					
tüm	all	adj					
tüm	entire	adj					
tüm	whole	adj					
Tunus	Tunisia	noun					
tür	sort	noun					
türbin	turbine	noun					
turist	tourist	noun					
turistik yer	sight	noun					
Türkçe	Turkish	noun					
Türkiye	Turkey <TR>	noun					
Türkmen	Turkmen	noun					
türkü	song	noun					
türlü	various	adj	bir türlü: somehow				
türlü türlü	miscellaneous	adj					
turuncu	orange (colour)	adj					
tutarlılık	consistency	noun					
tutmak	to hold	verb					
tutmak	to catch	verb					
tutmak	to hold	verb					
tütmek	to smoke	verb					
tütün	tobacco	noun					
tuvalet	lavatory	noun					
tuvalet	restroom [Am.]	noun					
tuvalet	toilet [Br.]	noun					
tuz	salt	noun	tuzağa düşmüş: trapped				
tuzlu	salty	adj					
uç	terminal	adj	uçup gitmek: to fly away				
uç	end	noun					
üç	three	noun					
üç bin	three thousand	noun					
üç yüz	three hundred	noun					
uçak	airplane [Am.]	noun					
uçak	plane	noun					
uçma	flight	noun					
uçmak	to fly	verb					
ücret	charge [fee]	noun					
ücretsiz	gratuitous	adj					
ücretsiz	free of charge	adj					
uçsuz bucaksız	vast	adj					
uçurum	cliff	noun					
uçuş	flight	noun					
ucuz	cheap	adj					
ufak	small	adj					
ufak lokanta	snack bar	noun					
üflemek	to blow	verb					
uğramak	to undergo	verb					
uğraşmak	to struggle	verb	bir şeyle uğraşmak: to bother with sg				
uğursuz	evil	adj					
ulan	damn	phrase					
ulaşmak	to reach	verb					
ülke	country	noun					
ulus	nation	noun
ulusal	national	adj
uluslararası	international	adj
umarsız	desperate	adj					
Umbria	Umbria	noun					
ümit	hope	noun					
ümit etmek	to hope	verb					
ümitsiz	desperate	adj					
ümitsizlik	bleakness [of a situation]	noun					
ümitsizlik	despair [feeling]	noun					
ümitsizlik	desperation	noun					
ummak	to hope	verb					
ummak	to expect	verb					
Umrumda değil.	I don't care.	phrase					
umursamayan	indifferent	adj					
umursamaz	unconcerned	adj	umursamaz bir şekilde: indifferently				
umut	hope	noun					
umut etmek	to hope	verb					
umutlarını kırmak	to disappoint	verb					
umutsuz	desperate	adj					
umutsuzluk	bleakness [of a situation]	noun					
umutsuzluk	despair [feeling]	noun					
umutsuzluk	desperation	noun					
un	flour	noun					
üniversite	university	noun					
ünlem	interjection	noun					
unutmak	to forget	verb					
üretim	production	noun					
üretmek	to produce	verb					
ürkmek	to flinch	verb					
ürpermek	to shake	verb					
ürün	product	noun					
Ürün Bilgi Yönetimi	Product Data Management <PDM>	noun					
üşengeçlik	ease	noun					
uskumru	mackerel	noun					
üst	top	adj	üst katta: upstairs	üst araması: body search			
üst taraf	top	noun					
usta	master	noun					
ustaca	on the sly	adj					
ustalaşmak	to master	verb					
ustalık	mastery	noun					
üstelik	besides	adv					
üstkol	upper arm	noun					
üstlenmek	to undertake	verb					
üstünde	above	prep					
üstünde	on top	adv					
üstünde	over	prep					
üstüne	onto	prep					
üşümek	to feel cold	verb					
üşütme	cold	noun					
utangaç	shy	adj					
utanmak	to be ashamed	verb					
utanmaz	cheeky	adj					
ütü yapmak	to iron	verb					
ütülemek	to iron	verb					
üvey anne	stepmother	noun					
üvey baba	stepfather	noun					
üvey kardeş	stepbrother	noun					
üvey kız	stepdaughter	noun					
üvey kızkardeş	stepsister	noun					
uyanık	awake	adj					
uyanmak	to wake up	verb					
uyarı	warning	noun					
uyarmak	to warn	verb					
uydu	satellite	noun					
üye	member	noun					
uygulamak	to apply	verb					
uygun	suitable	adj					
uygun	appropriate	adj					
uygun olmak	to do [be reasonable or acceptable]	verb					
Uygur	Uyghur	noun					
uyku	sleepy	noun					
uykulu	sleepy	adj					
uykuya dalmak	to fall asleep	verb					
uyluk	thigh	noun					
uymak	to fit	verb					
uyruk	nationality	noun					
uyum	adaptation	noun					
uyumak	to sleep	verb					
uyumlu	coherent	adj					
uyuşturucu	drug	noun					
uyuyakalmak	to fall asleep	verb					
uzak	far	adj					
uzak	away	adv					
uzak	far	adj					
uzaklık	distance	noun					
uzakta	away	adv					
uzamak	to hold over	verb					
uzanmak	to reach	verb					
uzanmak	to lie	verb					
Uzatma!	Cut it short! [coll.]	phrase					
uzay boşluğu	space	noun					
uzay turizmi	space tourism	noun					
uzayzaman	spacetime	noun					
üzere	about to	prep					
üzerinde	above	prep					
üzerinde	upon	prep					
üzerine	on	prep					
üzerine	onto	prep					
üzerine	upon	prep					
üzerine sünger çekmek	to bury	verb					
üzgün	sad	adj					
Üzgünüm.	I am sorry.	phrase					
uzlaştırma	compromise	noun					
uzman	expert	noun					
üzmek	to trouble	verb					
üzülmek	to be upset	verb					
üzülmek	to worry	verb					
üzüm	grape	noun					
üzüm	grapes {pl}	noun					
uzun	long	adj					
uzunluk	length	noun					
vadeli	temporary	adj					
vadi	valley	noun					
vahim	crucial	adj					
vakıa	fact	noun					
vakit	time	noun	yatma vakti: bedtime				
vakitli	on time	adv					
vakitli olmak	to be on time	verb					
vakitsiz	ill-timed	adj					
vaktinde	on time	adv					
vaktinde olmak	to be on time	verb					
vallahi	I swear	phrase					
vanilya	vanilla	noun					
var	there is	phrase					
var olan	available	adj					
vardı	sb./sth. had	phrase					
varis	heir	noun					
varış	arrival <arr.>	noun					
varlıklı	wealthy	adj					
varmak	to arrive	verb					
varoş	suburb	noun					
varsa	if any	phrase					
varyant	variant	noun					
vatandaş	citizen	noun	AB vatandaş: EU citizen				
vay	wow	phrase	vay be: wow	vay canina: wow			
vazgeçmek	to give up	verb					
vazife	duty	noun					
vazife	obligation	noun					
vaziyet	situation	noun					
vazo	vase	noun					
ve	and	conj					
veganizm	veganism	noun					
vejetaryen	vegetarian	adj					
vergi	fee	noun					
vergi	tax	noun					
vergiler dahil	VAT included	phrase					
verimsiz	unproductive	adj					
vermek	to give	verb					
verniyeli cetvel	vernier caliper	noun					
vesaire	etc	conj					
veteriner	vet	noun					
veya	or	conj					
vida	screw	noun					
vidalamak	to screw	verb					
viraj	bend	noun					
viski	whisky	noun					
vızıltı	hum	noun					
volkanoloji	volcanology	noun					
volkanoloji	vulcanology	noun					
vücut	body	noun					
vücut [şarap]	body [wine]	noun					
vuku bulmak	to happen	verb					
vura	hit	noun	vura vura: banging on				
vurgulamak	to emphasise [Br.]	verb					
vurmak	to hit	verb					
vurmak	to beat	verb					
vurmak	to hit	verb					
vurmak	to knock	verb					
vuruş	hit	noun					
ya	either	conj					
ya ... ya da	either ... or	conj					
ya da	or	conj					
yabancı	foreigner	noun					
yabancı	stranger	noun					
yabancı anahtar	foreign key	noun					
yağ	fat	noun					
yağ	oil	noun					
yağlı	fat	adj					
yağmak	to pour	verb	yağmur yağıyor: it's raining				
yağmur	rain	noun	yağmur yağıyor: it's raining				
yağmurlu	rainy	adj					
yahut	or	conj					
yaka	collar	noun					
yakalama	catch	noun	yakalama kararı: arrest warrant				
yakalamak	to catch	verb					
yakın	nearly	adv					
yakın	close	adj					
yakın	near	adj					
yakında	soon	adv					
yakınında	at	prep					
yakınında	nearby	prep					
yakışmak	to suit	verb					
yakışmak	to fit	verb					
yakıt	fuel	noun					
yaklaşık	about [circa]	adv					
yaklaşık	approximately <approx.>	adv					
yaklaşık olarak	about [circa]	adv					
yaklaşık olarak	approximately	adv					
yaklaşmak	to approach	verb					
yakma	incineration	noun					
yakmak	to turn on	verb					
yalaka	sycophant	adj					
yalan	lie	noun	yalan söylemek: to lie				
yalan söylemek	to lie [deceive]	verb					
yalancı	liar	noun					
yalaz	flame	noun					
yalın hal	nominative	noun					
yalnız	only	adv					
yalnız	alone	adv					
yalnız	but	conj					
yalnız	lonely	adj					
yalnız	only	adv					
yalnızca	alone	adv					
Yalta Konferansı [1945]	Yalta Conference	noun					
yaltakçı	sycophant	noun					
yan	side	noun	yan yana: side by side	yan çizmek: to evade	bir yandan: on the one hand	öte yandan: on the other hand	
yan	side	adj	yan etki: side effect				
yanak	cheek	noun					
yanaklar {pl}	cheeks {pl}	noun					
yanaşmak	to edge	verb					
yangın	fire	noun					
yani	so to speak	adv					
yanılmak	to be wrong	verb					
yanında	at	prep					
yanında	near	prep					
yanında	next to	prep					
yanısıra	as well as	conj					
yanıt	answer	noun					
yanıtlamak	to answer	verb					
yanlış	error	noun					
yanlış	FALSE	adj					
yanlış	mistake	noun					
yanma odası	combustion chamber	noun					
yanmak	to burn	verb					
yapabilir	sb. may [is permitted]	phrase					
yapışkan	coherent	adj					
yapışmak	to stick to	verb					
yapıştırmak	to paste	verb					
Yapma!	Drop it!	phrase					
yapmak	to build	verb					
yapmak	to do	verb					
yapmak	to make	verb					
yaprak	leaf	noun	yaprak dökümü: fall of the leaves				
yar	lover	noun					
yara	wound	noun					
yara	injury	noun					
yara	wound	noun					
yaralamak	to injure	verb					
yaralanma	injury	noun					
yaralanmış	hurt	adj					
yaramak	to serve	verb	işe yaramak: to be useful				
yaramak	to be useful	verb					
yaramaz	mischievous	adj					
yaramazlık	mischief	noun	yaramazlık yapmak: to misbehave				
yarar	benefit	noun					
yararlı	useful	adj					
yarasa doğanı [Falco rufigularis]	bat falcon	noun					
yaratmak	to create	verb					
yardakçı	stooge	noun					
yardım	help	noun					
yardım etmek	to help	verb					
yardımcı olmak	to help	verb					
yardımda bulunmak	to help	verb					
yardımına koşmak	to help	verb					
yarı	half	noun					
yarım	half	adj	yarım saattır: for half an hour				
yarım	half <hf.>	adv					
yarın	tomorrow	adv					
yarış	race	noun					
yarışmak	to run	verb					
yaş	age	noun					
yaş	tear	noun					
yaş	wet	adj					
yasa	law	noun					
yasadışı	illegal	adj					
yasak	forbidden	adj					
yasaklamak	to ban	verb					
yasaklamak	to forbid	verb					
yasaklamak	to prohibit	verb					
yaşamak	to live	verb	yaşamını yitirmek: to lose one's life				
yaşasın	hurray	phrase					
yaşlı	old	adj					
yastık	pillow	noun					
yatak	bed	noun					
yatay	horizontal	adj					
yatay asimptot	horizontal asymptote	noun					
yatay stabilize	horizontal stabilizer	noun					
yatırgaç	aileron	noun					
yatırmak	to put to bed	verb					
yatıştırmak	to placate	verb					
yatmak	to lie down	verb	yatma vakti: bedtime				
yatmak	to lie	verb					
yavaş	slow	adj					
yavaşlamak	to slow down	verb					
yaya	pedestrian	noun					
yaya kaldırımı	sidewalk [Am.]	noun					
yaygın	widespread	adj					
yaygın	usual	adj					
yayınlamak	to publish	verb					
yaymak	to scatter	verb					
yaz	summer	noun					
yazı tura atmak	to toss	verb					
Yazık!	Pity!	phrase					
Yazık.	Too bad.	phrase					
yazılım	software	noun					
yazmak	to write	verb					
yedek	replacement	noun					
yedi	seven	noun					
yedi yüz	seven hundred	noun					
Yedinci Mühür [Ingmar Bergman]	The Seventh Seal	phrase					
yeleli tembel hayvan [Bradypus torquatus]	maned sloth	noun					
yelkenle gitmek	to sail	verb					
yelkenliyle gitmek	to sail	verb					
yem vermek	to feed	verb					
yemek	dish	noun					
yemek	food	noun					
yemek	meal	noun					
yemek	to eat	verb					
yemek çubukları	chopsticks	noun					
yemek listesi	menu	noun					
yemek pişirme	cooking	noun					
yemek tarifi	recipe	noun					
yemek yapmak	to cook	verb					
yemek yemek	to eat	verb					
yemin	oath	noun	yemin etmek: to swear
yemin etmek	to swear [oath]	verb					
yemiş	fruit	noun					
yen	sleeve	noun					
yenge	aunt [related by marriage]	noun					
Yengeç Dönencesi	Tropic of Cancer	noun					
yengeç yağmurcunu [Dromas ardeola]	crab plover	noun					
yeni	new	adj					
Yeni yılınız kutlu olsun!	Happy New Year!	phrase					
yeniden düşünmek	to reconsider	verb					
yeniden ele almak	to reconsider	verb					
yer	floor	noun					
yer	location	noun					
yer	place	noun					
yer fıstık	peanut	noun					
yeraltı	underground	adj					
yere inmek	to land	verb					
yerel saat	local time	noun					
yerel zaman	local time	noun					
yerfıstıkları	peanuts	noun					
yerine koyma	substitution	noun					
yerine koymak	to replace	verb					
yerleştirmek	to place	verb					
yersiz sorular soran	inquisitive	adj					
yeşil	green	adj					
yeşil salata	green salad	noun					
yetenek	talent	noun					
yeterince	enough	adv					
yeterli olmak	to do [suffice]	verb					
yetersiz	insufficient	adj					
yetişkin	adult	noun					
yetişmek	to catch up with	verb					
yetişmek	to catch up	verb					
yetişmek	to grow	verb					
yetkili	official	adj					
yetmiş	seventy	noun					
yıkamak	to wash	verb					
yıkım	destruction	noun					
yıkmak	to destroy	verb					
yıl	year	noun	birkaç yıl önce: a few years ago				
yılan	snake	noun					
yılbaşı	New Year	noun					
yılbaşı gecesi	New Year's Eve	noun					
yıldan yıla	annually	adv					
yıldırım	lightning	noun					
yıldız	star	noun					
yıllık	anniversary	noun					
yıllık	annual	adj					
yıllık olarak	annually	adv					
yine	again	adv					
yine de	in spite of that	adv					
yinelemek	to recur	verb					
yirmi	twenty	noun					
yirmi bir	twenty-one	noun					
yırtmak	to tear	verb					
yiyecek	food	noun					
yoğun	busy	adj	çok yoğun bir gün: a very busy day				
yoğurt	yogurt	noun					
yok	no	part	yok artık: no way	yok etmek: to destroy			
yok	away	adv					
yok olmak	to disappear	verb					
yok olmak	to vanish	verb					
yok saymak	to ignore	verb					
yoklamak	to examine	verb					
yoksa	otherwise	conj					
yoksa	or	conj					
yoksun bırakmak	forego	verb					
yol	path	noun					
yol	way	noun					
yol	road <Rd.>	noun					
yol	way	noun					
yolculuğa çıkış	departure [on a journey]	noun					
yolculuk	journey	noun					
yolculuk	travel	noun					
yolculuk	trip	noun					
yolculuk etmek	to travel	verb					
Yoldayım!	I'm on my way!	phrase					
yollamak	to send	verb					
yön	direction	noun					
yönelik	aimed at	adj					
yönetici	director	noun					
yönetmek	to manage	verb					
yönetmek	to lead	verb					
yönetmen	director	noun					
yönlendirmek	to direct	verb					
yorgan	blanket	noun					
yorgun	tired	adj					
yormak	to exhaust	verb					
yormak	to tire	verb					
yorucu	exhausting	adj					
yorulmak	to tire	verb					
yorum	comment	noun					
yoruma açık	ambiguous	adj					
yorumcu	commentator	noun					
yorumda bulunmak	to comment on	verb					
yörünge	orbit	noun					
yörünge	trajectory	noun					
yük	burden	noun	yük kalkmak: to take off the load				
yukarı	up	adv	aşağı yukarı: more or less, approximately				
yukarıya	up	adv					
yüklemek	to load	verb					
yüksek	high	adj					
yükseliş	enhancement	noun					
yükselmek	to arise	verb					
yükselmek	to increase	verb					
yükseltmek	to raise	verb					
yumak yapmak	wind up	verb					
yumruk	fist	noun					
yumurta	egg	noun	yumurta bırakmak: to lay eggs	hikmet yumurtmak: to spread wisdom			
yumurta akı	egg white	noun					
yumurta akı	glair	noun					
yumurta kabı	egg cup	noun					
yumurta kabuğu	eggshell	noun					
yumurta sarısı	(egg) yolk	noun					
yumurta sarısı	yellow of an egg	noun					
yumurta sarısı	yolk	noun					
yumurtlamak	to spawn	verb					
yumuşak	soft	adj					
yün	wool	noun					
Yunanistan	Greece	noun					
yunuslama	pitch	noun					
yüreksiz	coward	noun					
yurt	dormitory [Am.]	noun					
yurt	home	noun					
yurtiçi uçuş	domestic flight	noun					
yürümek	to go	verb					
yürümek	to walk	verb					
yürütmek	to carry out	verb					
yürüyen merdiven	escalator	noun					
yürüyerek gitmek	to walk	verb					
yuva	nest	noun					
yuvarlamak	to roll	verb					
yuvarlanmak	to roll	verb					
yüz	face	noun	yüzüne: to one's face				
yüz	hundred	noun					
yüz	surface	noun					
yüzleşmek	to face	verb					
yüzmek	to swim	verb					
yüzük	ring	noun					
yüzük parmağı	ring finger	noun					
yüzünden	because of	conj					
yüzünden	due to	prep					
yüzyıl	century	noun					
zahmet	inconvenience	noun	zahmet olmazsa: if you don't mind				
zahmet	trouble	noun					
zahmetli	exhaustive	adj					
zaman	time	noun	o zaman: in that case	her zamanki gibi: as always	ne zaman: whenever	her zaman: always	uzun zaman önce: a long time ago
zamanında	on time	adv					
zamanında olmak	to be on time	verb					
zamir	pronoun	noun					
zan	supposition	noun	zannetmek: to suppose				
zanaat	trade	noun					
zanlı	culprit	noun					
zannetmek	to suppose	verb					
zar [oyun]	dice	noun					
zarar	damage	noun					
zarar vermek	to damage	verb					
zararlı	pernicious	adj					
zarf	envelope	noun					
zarf	adverb	noun					
zarf	envelope	noun					
zarfinda	within	prep	bir hafta zarfında: within a week				
zaten	already	adv					
zaten	anyway	adv					
zavallı	poor	adj					
zebra ispinozu [Taeniopygia guttata, syn.: Poephila guttata]	zebra finch	noun					
zehirlenme	intoxication [poisoning]	noun					
zehirlenme	poisoning [effect of sth. toxic]	noun					
zehirli	poisonous	adj					
zekâ	intelligence	noun					
zekalı	clever	adj					
zeki	bright	adj					
zeki	clever	adj					
zeki	intelligent	adj					
zeki	smart [intelligent]	adj					
zekice	clever	adj					
zelzele	earthquake	noun					
zemin kat	ground floor <GF>	noun					
zengin	rich	adj					
zerafetle	elegantly	adv					
zerafetle	gracefully	adv					
zerdali	peach	noun					
zevk	pleasure	noun					
zeytin	olive	noun					
zihin	mind	noun					
zihniyet	mentality	noun					
zil çalmak	to ring	verb					
zili çalmak	to ring	verb					
zincir	chain	noun					
zıplamak	to hop	verb					
ziyaret	visit	noun					
ziyaret etmek	to visit	verb					
ziyaretçi	visitor	noun					
zooloji	zoology	noun					
zor [ağır]	difficult	adj					
Zorlanma!	Don't bother!	phrase					
zorlu	demanding	adj					
zorunlu askerlik	conscription	noun					
zümrüdü	emerald	adj					
zürafa [Giraffa camelopardalis]	giraffe	noun					
